Day_Date,vaccinated,vaccinated_cum,vaccinated_population_perc,vaccinated_seconde_dose,vaccinated_seconde_dose_cum,vaccinated_seconde_dose_population_perc,vaccinated_third_dose,vaccinated_third_dose_cum,vaccinated_third_dose_population_perc,vaccinated_fourth_dose,vaccinated_fourth_dose_cum,vaccinated_fourth_dose_population_perc,vaccinated_validity_perc,vaccinated_expired_perc,not_vaccinated_perc
2020-12-19T00:00:00.000Z,46,68,0,0,4,0,0,0,0,0,0,0,0,0,100
2020-12-20T00:00:00.000Z,7391,7459,0.08,0,4,0,0,0,0,0,0,0,0,0,100
2020-12-21T00:00:00.000Z,24919,32378,0.35,0,4,0,0,0,0,0,0,0,0,0,100
2020-12-22T00:00:00.000Z,44656,77034,0.83,0,4,0,0,0,0,0,0,0,0,0,100
2020-12-23T00:00:00.000Z,62904,139938,1.5,0,4,0,0,0,0,0,0,0,0,0,100
2020-12-24T00:00:00.000Z,73420,213358,2.29,0,4,0,0,0,0,0,0,0,0,0,100
2020-12-25T00:00:00.000Z,38505,251863,2.71,0,4,0,0,0,0,0,0,0,0,0,100
2020-12-26T00:00:00.000Z,32612,284475,3.06,0,4,0,0,0,0,0,0,0,0,0,100
2020-12-27T00:00:00.000Z,104552,389027,4.18,0,4,0,0,0,0,0,0,0,0,0,100
2020-12-28T00:00:00.000Z,135000,524027,5.64,0,4,0,0,0,0,0,0,0,0,0,100
2020-12-29T00:00:00.000Z,156274,680301,7.32,2,6,0,0,0,0,0,0,0,0,0,100
2020-12-30T00:00:00.000Z,153133,833434,8.96,0,6,0,0,0,0,0,0,0,0,0,100
2020-12-31T00:00:00.000Z,158533,991967,10.67,0,6,0,0,0,0,0,0,0,0,0,100
2021-01-01T00:00:00.000Z,71408,1063375,11.43,0,6,0,0,0,0,0,0,0,0,0,100
2021-01-02T00:00:00.000Z,71719,1135094,12.21,0,6,0,0,0,0,0,0,0,0,0,100
2021-01-03T00:00:00.000Z,149716,1284810,13.82,0,6,0,0,0,0,0,0,0,0,0,100
2021-01-04T00:00:00.000Z,152159,1436969,15.45,1,7,0,0,0,0,0,0,0,0,0,100
2021-01-05T00:00:00.000Z,125160,1562129,16.8,3,10,0,0,0,0,0,0,0,0,0,100
2021-01-06T00:00:00.000Z,103317,1665446,17.91,2,12,0,0,0,0,0,0,0,0,0,100
2021-01-07T00:00:00.000Z,116010,1781456,19.16,9,21,0,0,0,0,0,0,0,0,0,100
2021-01-08T00:00:00.000Z,66433,1847889,19.87,4,25,0,0,0,0,0,0,0,0,0,100
2021-01-09T00:00:00.000Z,44527,1892416,20.35,24,49,0,0,0,0,0,0,0,0,0,100
2021-01-10T00:00:00.000Z,37628,1930044,20.75,5999,6048,0.07,0,0,0,0,0,0,0,0,100
2021-01-11T00:00:00.000Z,21155,1951199,20.98,19261,25309,0.27,0,0,0,0,0,0,0,0,100
2021-01-12T00:00:00.000Z,24055,1975254,21.24,35666,60975,0.66,0,0,0,0,0,0,0,0,100
2021-01-13T00:00:00.000Z,52048,2027302,21.8,56866,117841,1.27,0,0,0,0,0,0,0,0,100
2021-01-14T00:00:00.000Z,56446,2083748,22.41,68830,186671,2.01,0,0,0,0,0,0,0,0,100
2021-01-15T00:00:00.000Z,30754,2114502,22.74,35930,222601,2.39,0,0,0,0,0,0,0,0,100
2021-01-16T00:00:00.000Z,29464,2143966,23.06,26004,248605,2.67,0,0,0,0,0,0,0,0,100
2021-01-17T00:00:00.000Z,68417,2212383,23.79,84586,333191,3.58,0,0,0,0,0,0,0.31,0,99.69
2021-01-18T00:00:00.000Z,69783,2282166,24.54,120409,453600,4.88,0,0,0,0,0,0,0.58,0,99.42
2021-01-19T00:00:00.000Z,72867,2355033,25.32,137811,591411,6.36,0,0,0,0,0,0,1.09,0,98.91
2021-01-20T00:00:00.000Z,76877,2431910,26.15,143735,735146,7.91,0,0,0,0,0,0,1.9,0,98.1
2021-01-21T00:00:00.000Z,69967,2501877,26.9,164414,899560,9.67,0,0,0,0,0,0,2.88,0,97.12
2021-01-22T00:00:00.000Z,37908,2539785,27.31,71114,970674,10.44,0,0,0,0,0,0,3.39,0,96.61
2021-01-23T00:00:00.000Z,39958,2579743,27.74,53571,1024245,11.01,0,0,0,0,0,0,3.77,0,96.23
2021-01-24T00:00:00.000Z,69099,2648842,28.48,140674,1164919,12.53,0,0,0,0,0,0,4.96,0,95.04
2021-01-25T00:00:00.000Z,80903,2729745,29.35,139487,1304406,14.03,0,0,0,0,0,0,6.61,0,93.39
2021-01-26T00:00:00.000Z,78691,2808436,30.2,126396,1430802,15.39,0,0,0,0,0,0,8.45,0,91.55
2021-01-27T00:00:00.000Z,77940,2886376,31.04,125030,1555832,16.73,0,0,0,0,0,0,10.34,0,89.66
2021-01-28T00:00:00.000Z,79544,2965920,31.89,130590,1686422,18.14,0,0,0,0,0,0,12.43,0,87.57
2021-01-29T00:00:00.000Z,36681,3002601,32.29,64773,1751195,18.83,0,0,0,0,0,0,13.34,0,86.66
2021-01-30T00:00:00.000Z,34388,3036989,32.66,42753,1793948,19.29,0,0,0,0,0,0,14.02,0,85.98
2021-01-31T00:00:00.000Z,73314,3110303,33.45,59485,1853433,19.93,0,0,0,0,0,0,15.76,0,84.24
2021-02-01T00:00:00.000Z,82476,3192779,34.33,35338,1888771,20.31,0,0,0,0,0,0,17.48,0,82.52
2021-02-02T00:00:00.000Z,70073,3262852,35.09,31056,1919827,20.64,0,0,0,0,0,0,19.01,0,80.99
2021-02-03T00:00:00.000Z,60279,3323131,35.74,51422,1971249,21.2,0,0,0,0,0,0,20.47,0,79.53
2021-02-04T00:00:00.000Z,72601,3395732,36.52,58075,2029324,21.82,0,0,0,0,0,0,22,0,78
2021-02-05T00:00:00.000Z,33923,3429655,36.88,28790,2058114,22.13,0,0,0,0,0,0,22.75,0,77.25
2021-02-06T00:00:00.000Z,21612,3451267,37.11,22226,2080340,22.37,0,0,0,0,0,0,23.23,0,76.77
2021-02-07T00:00:00.000Z,54068,3505335,37.69,68720,2149060,23.11,0,0,0,0,0,0,23.99,0,76.01
2021-02-08T00:00:00.000Z,58621,3563956,38.32,65446,2214506,23.81,0,0,0,0,0,0,24.52,0,75.48
2021-02-09T00:00:00.000Z,66323,3630279,39.04,67555,2282061,24.54,0,0,0,0,0,0,25.04,0,74.96
2021-02-10T00:00:00.000Z,70544,3700823,39.8,72289,2354350,25.32,0,0,0,0,0,0,25.77,0,74.23
2021-02-11T00:00:00.000Z,81144,3781967,40.67,72084,2426434,26.09,0,0,0,0,0,0,26.61,0,73.39
2021-02-12T00:00:00.000Z,39087,3821054,41.09,37573,2464007,26.5,0,0,0,0,0,0,27.02,0,72.98
2021-02-13T00:00:00.000Z,27456,3848510,41.38,30432,2494439,26.82,0,0,0,0,0,0,27.33,0,72.67
2021-02-14T00:00:00.000Z,74891,3923401,42.19,69062,2563501,27.57,0,0,0,0,0,0,28.25,0,71.75
2021-02-15T00:00:00.000Z,81521,4004922,43.07,75684,2639185,28.38,0,0,0,0,0,0,29.17,0,70.83
2021-02-16T00:00:00.000Z,83404,4088326,43.96,78270,2717455,29.22,0,0,0,0,0,0,30.11,0,69.89
2021-02-17T00:00:00.000Z,61961,4150287,44.63,75613,2793068,30.04,0,0,0,0,0,0,31.01,0,68.99
2021-02-18T00:00:00.000Z,69139,4219426,45.37,79715,2872783,30.89,0,0,0,0,0,0,31.94,0,68.06
2021-02-19T00:00:00.000Z,39656,4259082,45.8,38140,2910923,31.3,0,0,0,0,0,0,32.45,0,67.55
2021-02-20T00:00:00.000Z,31643,4290725,46.14,28720,2939643,31.61,0,0,0,0,0,0,32.85,0,67.15
2021-02-21T00:00:00.000Z,79415,4370140,46.99,78427,3018070,32.45,0,0,0,0,0,0,33.8,0,66.2
2021-02-22T00:00:00.000Z,85044,4455184,47.91,80578,3098648,33.32,0,0,0,0,0,0,34.83,0,65.17
2021-02-23T00:00:00.000Z,77316,4532500,48.74,70462,3169110,34.08,0,0,0,0,0,0,35.84,0,64.16
2021-02-24T00:00:00.000Z,61043,4593543,49.4,63115,3232225,34.76,0,0,0,0,0,0,36.76,0,63.24
2021-02-25T00:00:00.000Z,51709,4645252,49.95,64783,3297008,35.45,0,0,0,0,0,0,37.66,0,62.34
2021-02-26T00:00:00.000Z,25899,4671151,50.23,32024,3329032,35.8,0,0,0,0,0,0,38.1,0,61.9
2021-02-27T00:00:00.000Z,18342,4689493,50.43,21192,3350224,36.03,0,0,0,0,0,0,38.42,0,61.58
2021-02-28T00:00:00.000Z,40345,4729838,50.86,55862,3406086,36.63,0,0,0,0,0,0,39.24,0,60.76
2021-03-01T00:00:00.000Z,45719,4775557,51.35,61426,3467512,37.29,0,0,0,0,0,0,40.1,0,59.9
2021-03-02T00:00:00.000Z,41175,4816732,51.8,64775,3532287,37.98,0,0,0,0,0,0,40.85,0,59.15
2021-03-03T00:00:00.000Z,42011,4858743,52.25,66761,3599048,38.7,0,0,0,0,0,0,41.55,0,58.45
2021-03-04T00:00:00.000Z,39690,4898433,52.68,79102,3678150,39.55,0,0,0,0,0,0,42.24,0,57.76
2021-03-05T00:00:00.000Z,17343,4915776,52.86,40452,3718602,39.99,0,0,0,0,0,0,42.57,0,57.43
2021-03-06T00:00:00.000Z,10709,4926485,52.98,25341,3743943,40.26,0,0,0,0,0,0,42.78,0,57.22
2021-03-07T00:00:00.000Z,31139,4957624,53.31,72833,3816776,41.04,0,0,0,0,0,0,43.36,0,56.64
2021-03-08T00:00:00.000Z,27368,4984992,53.61,73275,3890051,41.83,0,0,0,0,0,0,43.97,0,56.03
2021-03-09T00:00:00.000Z,26731,5011723,53.89,76585,3966636,42.66,0,0,0,0,0,0,44.62,0,55.38
2021-03-10T00:00:00.000Z,23340,5035063,54.14,58664,4025300,43.29,0,0,0,0,0,0,45.27,0,54.73
2021-03-11T00:00:00.000Z,23291,5058354,54.4,69077,4094377,44.03,0,0,0,0,0,0,45.99,0,54.01
2021-03-12T00:00:00.000Z,11269,5069623,54.52,41401,4135778,44.47,0,0,0,0,0,0,46.34,0,53.66
2021-03-13T00:00:00.000Z,7935,5077558,54.6,25234,4161012,44.75,0,0,0,0,0,0,46.57,0,53.43
2021-03-14T00:00:00.000Z,20973,5098531,54.83,73925,4234937,45.54,0,0,0,0,0,0,47.2,0,52.8
2021-03-15T00:00:00.000Z,20128,5118659,55.04,78262,4313199,46.38,0,0,0,0,0,0,47.81,0,52.19
2021-03-16T00:00:00.000Z,18735,5137394,55.24,71467,4384666,47.15,0,0,0,0,0,0,48.43,0,51.57
2021-03-17T00:00:00.000Z,17682,5155076,55.44,58990,4443656,47.78,0,0,0,0,0,0,48.92,0,51.08
2021-03-18T00:00:00.000Z,16032,5171108,55.61,58118,4501774,48.41,0,0,0,0,0,0,49.45,0,50.55
2021-03-19T00:00:00.000Z,6937,5178045,55.68,27969,4529743,48.71,0,0,0,0,0,0,49.75,0,50.25
2021-03-20T00:00:00.000Z,5214,5183259,55.74,15290,4545033,48.88,0,0,0,0,0,0,49.93,0,50.07
2021-03-21T00:00:00.000Z,13154,5196413,55.88,40493,4585526,49.31,0,0,0,0,0,0,50.46,0,49.54
2021-03-22T00:00:00.000Z,13560,5209973,56.03,40524,4626050,49.75,0,0,0,0,0,0,51,0,49
2021-03-23T00:00:00.000Z,2821,5212794,56.06,7286,4633336,49.82,0,0,0,0,0,0,51.43,0,48.57
2021-03-24T00:00:00.000Z,10986,5223780,56.17,46540,4679876,50.33,0,0,0,0,0,0,51.84,0,48.16
2021-03-25T00:00:00.000Z,10235,5234015,56.28,35414,4715290,50.71,0,0,0,0,0,0,52.22,0,47.78
2021-03-26T00:00:00.000Z,4172,5238187,56.33,13324,4728614,50.85,0,0,0,0,0,0,52.4,0,47.6
2021-03-27T00:00:00.000Z,1777,5239964,56.35,4263,4732877,50.9,0,0,0,0,0,0,52.5,0,47.5
2021-03-28T00:00:00.000Z,2099,5242063,56.37,4601,4737478,50.94,0,0,0,0,0,0,52.74,0,47.26
2021-03-29T00:00:00.000Z,6894,5248957,56.44,30002,4767480,51.27,0,0,0,0,0,0,53,0,47
2021-03-30T00:00:00.000Z,7866,5256823,56.53,22435,4789915,51.51,0,0,0,0,0,0,53.08,0,46.92
2021-03-31T00:00:00.000Z,8131,5264954,56.62,19473,4809388,51.72,0,0,0,0,0,0,53.38,0,46.62
2021-04-01T00:00:00.000Z,8184,5273138,56.7,18683,4828071,51.92,0,0,0,0,0,0,53.62,0,46.38
2021-04-02T00:00:00.000Z,2916,5276054,56.74,8120,4836191,52.01,0,0,0,0,0,0,53.71,0,46.29
2021-04-03T00:00:00.000Z,1420,5277474,56.75,2964,4839155,52.04,0,0,0,0,0,0,53.74,0,46.26
2021-04-04T00:00:00.000Z,9611,5287085,56.85,22822,4861977,52.28,0,0,0,0,0,0,53.82,0,46.18
2021-04-05T00:00:00.000Z,10334,5297419,56.97,21260,4883237,52.51,0,0,0,0,0,0,54.04,0,45.96
2021-04-06T00:00:00.000Z,9005,5306424,57.06,16776,4900013,52.69,0,0,0,0,0,0,54.21,0,45.79
2021-04-07T00:00:00.000Z,8901,5315325,57.16,15290,4915303,52.86,0,0,0,0,0,0,54.36,0,45.64
2021-04-08T00:00:00.000Z,9401,5324726,57.26,16991,4932294,53.04,0,0,0,0,0,0,54.52,0,45.48
2021-04-09T00:00:00.000Z,3586,5328312,57.3,6232,4938526,53.11,0,0,0,0,0,0,54.58,0,45.42
2021-04-10T00:00:00.000Z,1625,5329937,57.32,3510,4942036,53.14,0,0,0,0,0,0,54.61,0,45.39
2021-04-11T00:00:00.000Z,9023,5338960,57.41,14237,4956273,53.3,0,0,0,0,0,0,54.78,0,45.22
2021-04-12T00:00:00.000Z,8921,5347881,57.51,13218,4969491,53.44,0,0,0,0,0,0,54.95,0,45.05
2021-04-13T00:00:00.000Z,5825,5353706,57.57,4940,4974431,53.49,0,0,0,0,0,0,55.08,0,44.92
2021-04-14T00:00:00.000Z,3630,5357336,57.61,5292,4979723,53.55,0,0,0,0,0,0,55.18,0,44.82
2021-04-15T00:00:00.000Z,679,5358015,57.62,566,4980289,53.56,0,0,0,0,0,0,55.27,0,44.73
2021-04-16T00:00:00.000Z,3397,5361412,57.65,6631,4986920,53.63,0,0,0,0,0,0,55.33,0,44.67
2021-04-17T00:00:00.000Z,809,5362221,57.66,1967,4988887,53.65,0,0,0,0,0,0,55.35,0,44.65
2021-04-18T00:00:00.000Z,7088,5369309,57.74,7425,4996312,53.73,0,0,0,0,0,0,55.47,0,44.53
2021-04-19T00:00:00.000Z,6387,5375696,57.81,7107,5003419,53.8,0,0,0,0,0,0,55.58,0,44.42
2021-04-20T00:00:00.000Z,6266,5381962,57.88,6866,5010285,53.88,0,0,0,0,0,0,55.65,0,44.35
2021-04-21T00:00:00.000Z,6363,5388325,57.94,7086,5017371,53.95,0,0,0,0,0,0,55.71,0,44.29
2021-04-22T00:00:00.000Z,5926,5394251,58.01,7671,5025042,54.04,0,0,0,0,0,0,55.75,0,44.25
2021-04-23T00:00:00.000Z,2747,5396998,58.04,3368,5028410,54.07,0,0,0,0,0,0,55.8,0,44.2
2021-04-24T00:00:00.000Z,760,5397758,58.04,1281,5029691,54.09,0,0,0,0,0,0,55.82,0,44.18
2021-04-25T00:00:00.000Z,4823,5402581,58.1,6910,5036601,54.16,0,0,0,0,0,0,55.89,0,44.11
2021-04-26T00:00:00.000Z,5463,5408044,58.16,7873,5044474,54.25,0,0,0,0,0,0,55.96,0,44.04
2021-04-27T00:00:00.000Z,4493,5412537,58.2,6611,5051085,54.32,0,0,0,0,0,0,56.03,0,43.97
2021-04-28T00:00:00.000Z,4476,5417013,58.25,7297,5058382,54.4,0,0,0,0,0,0,56.09,0,43.91
2021-04-29T00:00:00.000Z,4351,5421364,58.3,7271,5065653,54.47,0,0,0,0,0,0,56.16,0,43.84
2021-04-30T00:00:00.000Z,1909,5423273,58.32,3176,5068829,54.51,0,0,0,0,0,0,56.19,0,43.81
2021-05-01T00:00:00.000Z,451,5423724,58.32,889,5069718,54.52,0,0,0,0,0,0,56.2,0,43.8
2021-05-02T00:00:00.000Z,3216,5426940,58.36,6077,5075795,54.58,0,0,0,0,0,0,56.26,0,43.74
2021-05-03T00:00:00.000Z,3534,5430474,58.4,5811,5081606,54.65,0,0,0,0,0,0,56.32,0,43.68
2021-05-04T00:00:00.000Z,3572,5434046,58.44,4712,5086318,54.7,0,0,0,0,0,0,56.38,0,43.62
2021-05-05T00:00:00.000Z,3275,5437321,58.47,4072,5090390,54.74,0,0,0,0,0,0,56.44,0,43.56
2021-05-06T00:00:00.000Z,3627,5440948,58.51,3131,5093521,54.77,0,0,0,0,0,0,56.5,0,43.5
2021-05-07T00:00:00.000Z,1815,5442763,58.53,2489,5096010,54.8,0,0,0,0,0,0,56.52,0,43.48
2021-05-08T00:00:00.000Z,230,5442993,58.53,497,5096507,54.81,0,0,0,0,0,0,56.53,0,43.47
2021-05-09T00:00:00.000Z,2840,5445833,58.56,4744,5101251,54.86,0,0,0,0,0,0,56.58,0,43.42
2021-05-10T00:00:00.000Z,2887,5448720,58.59,4690,5105941,54.91,0,0,0,0,0,0,56.63,0,43.37
2021-05-11T00:00:00.000Z,2610,5451330,58.62,3864,5109805,54.95,0,0,0,0,0,0,56.67,0,43.33
2021-05-12T00:00:00.000Z,2008,5453338,58.64,3324,5113129,54.98,0,0,0,0,0,0,56.7,0,43.3
2021-05-13T00:00:00.000Z,2029,5455367,58.66,3664,5116793,55.02,0,0,0,0,0,0,56.73,0,43.27
2021-05-14T00:00:00.000Z,961,5456328,58.67,1478,5118271,55.04,0,0,0,0,0,0,56.75,0,43.25
2021-05-15T00:00:00.000Z,242,5456570,58.68,249,5118520,55.04,0,0,0,0,0,0,56.75,0,43.25
2021-05-16T00:00:00.000Z,524,5457094,58.68,1199,5119719,55.05,0,0,0,0,0,0,56.78,0,43.22
2021-05-17T00:00:00.000Z,288,5457382,58.69,832,5120551,55.06,0,0,0,0,0,0,56.81,0,43.19
2021-05-18T00:00:00.000Z,1949,5459331,58.71,4923,5125474,55.12,0,0,0,0,0,0,56.84,0,43.16
2021-05-19T00:00:00.000Z,2211,5461542,58.73,5028,5130502,55.17,0,0,0,0,0,0,56.87,0,43.13
2021-05-20T00:00:00.000Z,2301,5463843,58.76,3863,5134365,55.21,0,0,0,0,0,0,56.9,0,43.1
2021-05-21T00:00:00.000Z,1175,5465018,58.77,1390,5135755,55.23,0,0,0,0,0,0,56.92,0,43.08
2021-05-22T00:00:00.000Z,204,5465222,58.77,386,5136141,55.23,0,0,0,0,0,0,56.92,0,43.08
2021-05-23T00:00:00.000Z,2267,5467489,58.79,3212,5139353,55.27,0,0,0,0,0,0,56.94,0,43.06
2021-05-24T00:00:00.000Z,2113,5469602,58.82,3588,5142941,55.3,0,0,0,0,0,0,56.96,0,43.04
2021-05-25T00:00:00.000Z,1809,5471411,58.84,2573,5145514,55.33,0,0,0,0,0,0,56.99,0,43.01
2021-05-26T00:00:00.000Z,1394,5472805,58.85,2489,5148003,55.36,0,0,0,0,0,0,57.03,0,42.97
2021-05-27T00:00:00.000Z,1830,5474635,58.87,3171,5151174,55.39,0,0,0,0,0,0,57.06,0,42.94
2021-05-28T00:00:00.000Z,764,5475399,58.88,1393,5152567,55.41,0,0,0,0,0,0,57.07,0,42.93
2021-05-29T00:00:00.000Z,177,5475576,58.88,220,5152787,55.41,0,0,0,0,0,0,57.07,0,42.93
2021-05-30T00:00:00.000Z,1630,5477206,58.9,1925,5154712,55.43,0,0,0,0,0,0,57.1,0,42.9
2021-05-31T00:00:00.000Z,1717,5478923,58.92,2082,5156794,55.45,0,0,0,0,0,0,57.13,0,42.87
2021-06-01T00:00:00.000Z,1359,5480282,58.93,1811,5158605,55.47,0,0,0,0,0,0,57.47,0,42.53
2021-06-02T00:00:00.000Z,1490,5481772,58.95,1597,5160202,55.49,0,0,0,0,0,0,57.25,0,42.75
2021-06-03T00:00:00.000Z,1666,5483438,58.97,1479,5161681,55.51,0,0,0,0,0,0,57.27,0,42.73
2021-06-04T00:00:00.000Z,1074,5484512,58.98,767,5162448,55.51,0,0,0,0,0,0,57.28,0,42.72
2021-06-05T00:00:00.000Z,177,5484689,58.98,150,5162598,55.52,0,0,0,0,0,0,57.29,0,42.71
2021-06-06T00:00:00.000Z,4276,5488965,59.03,994,5163592,55.53,0,0,0,0,0,0,57.31,0,42.69
2021-06-07T00:00:00.000Z,4415,5493380,59.07,800,5164392,55.54,0,0,0,0,0,0,57.34,0,42.66
2021-06-08T00:00:00.000Z,3723,5497103,59.11,1157,5165549,55.55,0,0,0,0,0,0,57.36,0,42.64
2021-06-09T00:00:00.000Z,3594,5500697,59.15,1305,5166854,55.56,0,0,0,0,0,0,57.4,0,42.6
2021-06-10T00:00:00.000Z,3341,5504038,59.19,1285,5168139,55.58,0,0,0,0,0,0,57.42,0,42.58
2021-06-11T00:00:00.000Z,1377,5505415,59.2,571,5168710,55.58,0,0,0,0,0,0,57.43,0,42.57
2021-06-12T00:00:00.000Z,209,5505624,59.2,164,5168874,55.58,0,0,0,0,0,0,57.43,0,42.57
2021-06-13T00:00:00.000Z,3092,5508716,59.24,1249,5170123,55.6,0,0,0,0,0,0,57.45,0,42.55
2021-06-14T00:00:00.000Z,3041,5511757,59.27,1518,5171641,55.61,0,0,0,0,0,0,57.46,0,42.54
2021-06-15T00:00:00.000Z,3125,5514882,59.3,1359,5173000,55.63,0,0,0,0,0,0,57.48,0,42.52
2021-06-16T00:00:00.000Z,2709,5517591,59.33,984,5173984,55.64,0,0,0,0,0,0,57.49,0,42.51
2021-06-17T00:00:00.000Z,2714,5520305,59.36,1185,5175169,55.65,0,0,0,0,0,0,57.51,0,42.49
2021-06-18T00:00:00.000Z,1247,5521552,59.38,486,5175655,55.66,0,0,0,0,0,0,57.52,0,42.48
2021-06-19T00:00:00.000Z,222,5521774,59.38,135,5175790,55.66,0,0,0,0,0,0,57.52,0,42.48
2021-06-20T00:00:00.000Z,3309,5525083,59.41,1321,5177111,55.67,0,0,0,0,0,0,57.54,0,42.46
2021-06-21T00:00:00.000Z,5231,5530314,59.47,1199,5178310,55.68,0,0,0,0,0,0,57.56,0,42.44
2021-06-22T00:00:00.000Z,6908,5537222,59.54,1089,5179399,55.7,0,0,0,0,0,0,57.58,0,42.42
2021-06-23T00:00:00.000Z,10721,5547943,59.66,1280,5180679,55.71,0,0,0,0,0,0,57.6,0,42.4
2021-06-24T00:00:00.000Z,12016,5559959,59.79,1449,5182128,55.73,0,0,0,0,0,0,57.62,0,42.38
2021-06-25T00:00:00.000Z,7084,5567043,59.87,922,5183050,55.74,0,0,0,0,0,0,57.62,0,42.38
2021-06-26T00:00:00.000Z,2260,5569303,59.89,190,5183240,55.74,0,0,0,0,0,0,57.63,0,42.37
2021-06-27T00:00:00.000Z,13617,5582920,60.04,3430,5186670,55.77,0,0,0,0,0,0,57.65,0,42.35
2021-06-28T00:00:00.000Z,14501,5597421,60.19,3663,5190333,55.81,0,0,0,0,0,0,57.68,0,42.32
2021-06-29T00:00:00.000Z,16693,5614114,60.37,3721,5194054,55.85,0,0,0,0,0,0,57.69,0,42.31
2021-06-30T00:00:00.000Z,16462,5630576,60.55,3381,5197435,55.89,0,0,0,0,0,0,57.72,0,42.28
2021-07-01T00:00:00.000Z,16796,5647372,60.73,3359,5200794,55.93,89,89,0,0,0,0,57.78,0,42.22
2021-07-02T00:00:00.000Z,9814,5657186,60.83,1583,5202377,55.94,5,94,0,0,0,0,57.79,0,42.21
2021-07-03T00:00:00.000Z,2660,5659846,60.86,293,5202670,55.95,1,95,0,0,0,0,57.79,0,42.21
2021-07-04T00:00:00.000Z,17720,5677566,61.05,3152,5205822,55.98,1,96,0,0,0,0,57.85,0,42.15
2021-07-05T00:00:00.000Z,17838,5695404,61.25,3030,5208852,56.01,6,102,0,0,0,0,57.91,0,42.09
2021-07-06T00:00:00.000Z,17825,5713229,61.44,3394,5212246,56.05,10,112,0,0,0,0,57.99,0,42.01
2021-07-07T00:00:00.000Z,15505,5728734,61.6,2681,5214927,56.08,12,124,0,0,0,0,58.05,0,41.95
2021-07-08T00:00:00.000Z,16569,5745303,61.78,2855,5217782,56.11,17,141,0,0,0,0,58.12,0,41.88
2021-07-09T00:00:00.000Z,11113,5756416,61.9,1514,5219296,56.13,3,144,0,0,0,0,58.15,0,41.85
2021-07-10T00:00:00.000Z,4973,5761389,61.96,375,5219671,56.13,5,149,0,0,0,0,58.15,0,41.85
2021-07-11T00:00:00.000Z,1452,5762841,61.97,2842,5222513,56.16,6,155,0,0,0,0,58.22,0,41.78
2021-07-12T00:00:00.000Z,2409,5765250,62,3667,5226180,56.2,52,207,0,0,0,0,58.29,0,41.71
2021-07-13T00:00:00.000Z,2944,5768194,62.03,5439,5231619,56.26,124,331,0,0,0,0,58.36,0,41.64
2021-07-14T00:00:00.000Z,2723,5770917,62.06,7501,5239120,56.34,441,772,0.01,0,0,0,58.42,0,41.58
2021-07-15T00:00:00.000Z,2974,5773891,62.09,9269,5248389,56.44,374,1146,0.01,0,0,0,58.5,0,41.5
2021-07-16T00:00:00.000Z,1269,5775160,62.1,5867,5254256,56.5,65,1211,0.01,0,0,0,58.54,0,41.46
2021-07-17T00:00:00.000Z,355,5775515,62.11,1381,5255637,56.52,7,1218,0.01,0,0,0,58.55,0,41.44
2021-07-18T00:00:00.000Z,2053,5777568,62.13,9763,5265400,56.62,235,1453,0.02,0,0,0,58.6,0,41.4
2021-07-19T00:00:00.000Z,3191,5780759,62.16,11326,5276726,56.74,459,1912,0.02,0,0,0,58.65,0,41.35
2021-07-20T00:00:00.000Z,2661,5783420,62.19,11892,5288618,56.87,371,2283,0.02,0,0,0,58.72,0,41.28
2021-07-21T00:00:00.000Z,2375,5785795,62.22,11856,5300474,57,323,2606,0.03,0,0,0,58.81,0,41.19
2021-07-22T00:00:00.000Z,2856,5788651,62.25,13242,5313716,57.14,390,2996,0.03,0,0,0,58.93,0,41.07
2021-07-23T00:00:00.000Z,2016,5790667,62.27,8210,5321926,57.23,105,3101,0.03,0,0,0,58.99,0,41.01
2021-07-24T00:00:00.000Z,624,5791291,62.28,1469,5323395,57.25,6,3107,0.03,0,0,0,58.99,0,41
2021-07-25T00:00:00.000Z,4408,5795699,62.32,15480,5338875,57.41,223,3330,0.04,0,0,0,59.1,0,40.89
2021-07-26T00:00:00.000Z,5152,5800851,62.38,13508,5352383,57.56,322,3652,0.04,0,0,0,59.24,0,40.75
2021-07-27T00:00:00.000Z,5471,5806322,62.44,13546,5365929,57.7,413,4065,0.04,0,0,0,59.37,0.01,40.62
2021-07-28T00:00:00.000Z,3975,5810297,62.48,12318,5378247,57.84,470,4535,0.05,0,0,0,59.5,0.01,40.49
2021-07-29T00:00:00.000Z,4642,5814939,62.53,14159,5392406,57.99,529,5064,0.05,0,0,0,59.65,0.01,40.33
2021-07-30T00:00:00.000Z,2638,5817577,62.56,10835,5403241,58.1,4117,9181,0.1,0,0,0,59.74,0.02,40.25
2021-07-31T00:00:00.000Z,1395,5818972,62.57,3540,5406781,58.14,6156,15337,0.16,0,0,0,59.75,0.02,40.23
2021-08-01T00:00:00.000Z,3067,5822039,62.61,3350,5410131,58.18,31042,46379,0.5,0,0,0,59.91,0.02,40.06
2021-08-02T00:00:00.000Z,3112,5825151,62.64,3156,5413287,58.21,58503,104882,1.13,0,0,0,60.06,0.03,39.91
2021-08-03T00:00:00.000Z,3373,5828524,62.68,3301,5416588,58.25,78949,183831,1.98,0,0,0,60.21,0.03,39.76
2021-08-04T00:00:00.000Z,3513,5832037,62.71,3231,5419819,58.28,80757,264588,2.85,0,0,0,60.34,0.03,39.63
2021-08-05T00:00:00.000Z,4494,5836531,62.76,3552,5423371,58.32,88435,353023,3.8,0,0,0,60.49,0.04,39.47
2021-08-06T00:00:00.000Z,2409,5838940,62.79,1835,5425206,58.34,44738,397761,4.28,0,0,0,60.6,0.04,39.36
2021-08-07T00:00:00.000Z,1018,5839958,62.8,670,5425876,58.35,27348,425109,4.57,0,0,0,60.63,0.04,39.32
2021-08-08T00:00:00.000Z,4992,5844950,62.85,3060,5428936,58.38,80080,505189,5.43,0,0,0,60.68,0.04,39.28
2021-08-09T00:00:00.000Z,5329,5850279,62.91,3036,5431972,58.41,76480,581669,6.25,0,0,0,60.72,0.04,39.24
2021-08-10T00:00:00.000Z,5540,5855819,62.97,3177,5435149,58.45,75416,657085,7.07,0,0,0,60.75,0.04,39.2
2021-08-11T00:00:00.000Z,5676,5861495,63.03,2929,5438078,58.48,62627,719712,7.74,0,0,0,60.79,0.04,39.17
2021-08-12T00:00:00.000Z,7015,5868510,63.11,3274,5441352,58.51,59455,779167,8.38,0,0,0,60.83,0.04,39.12
2021-08-13T00:00:00.000Z,3798,5872308,63.15,2051,5443403,58.54,43860,823027,8.85,0,0,0,60.84,0.05,39.11
2021-08-14T00:00:00.000Z,2246,5874554,63.17,843,5444246,58.54,44478,867505,9.33,0,0,0,60.85,0.05,39.1
2021-08-15T00:00:00.000Z,7152,5881706,63.25,4520,5448766,58.59,97955,965460,10.38,0,0,0,60.89,0.05,39.06
2021-08-16T00:00:00.000Z,6974,5888680,63.32,4729,5453495,58.64,89502,1054962,11.34,0,0,0,60.92,0.04,39.03
2021-08-17T00:00:00.000Z,7572,5896252,63.41,5119,5458614,58.7,83297,1138259,12.24,0,0,0,60.96,0.04,39
2021-08-18T00:00:00.000Z,8630,5904882,63.5,4597,5463211,58.75,69245,1207504,12.98,0,0,0,60.99,0.04,38.96
2021-08-19T00:00:00.000Z,10067,5914949,63.61,5199,5468410,58.8,65961,1273465,13.69,0,0,0,61.03,0.04,38.92
2021-08-20T00:00:00.000Z,4750,5919699,63.66,2799,5471209,58.83,60435,1333900,14.34,0,0,0,61.05,0.05,38.9
2021-08-21T00:00:00.000Z,3493,5923192,63.7,1564,5472773,58.85,50710,1384610,14.89,0,0,0,61.06,0.05,38.89
2021-08-22T00:00:00.000Z,9833,5933025,63.8,4787,5477560,58.9,105074,1489684,16.02,0,0,0,61.12,0.04,38.84
2021-08-23T00:00:00.000Z,10929,5943954,63.92,4427,5481987,58.95,93987,1583671,17.03,0,0,0,61.17,0.04,38.79
2021-08-24T00:00:00.000Z,11724,5955678,64.04,4694,5486681,59,98505,1682176,18.09,0,0,0,61.23,0.04,38.73
2021-08-25T00:00:00.000Z,9615,5965293,64.15,4470,5491151,59.05,99476,1781652,19.16,0,0,0,61.29,0.04,38.67
2021-08-26T00:00:00.000Z,10106,5975399,64.26,5038,5496189,59.1,101168,1882820,20.25,0,0,0,61.36,0.03,38.61
2021-08-27T00:00:00.000Z,4320,5979719,64.3,2766,5498955,59.13,56667,1939487,20.86,0,0,0,61.35,0.04,38.61
2021-08-28T00:00:00.000Z,3694,5983413,64.34,1484,5500439,59.15,33520,1973007,21.22,0,0,0,61.4,0.04,38.57
2021-08-29T00:00:00.000Z,10340,5993753,64.45,5932,5506371,59.21,79484,2052491,22.07,0,0,0,61.46,0.03,38.5
2021-08-30T00:00:00.000Z,12338,6006091,64.59,7004,5513375,59.29,115962,2168453,23.32,0,0,0,61.53,0.03,38.44
2021-08-31T00:00:00.000Z,12084,6018175,64.72,6507,5519882,59.36,114819,2283272,24.55,0,0,0,61.6,0.03,38.37
2021-09-01T00:00:00.000Z,9044,6027219,64.81,6006,5525888,59.42,112442,2395714,25.76,0,0,0,61.43,0.03,38.54
2021-09-02T00:00:00.000Z,8790,6036009,64.91,7159,5533047,59.5,111488,2507202,26.96,0,0,0,61.49,0.03,38.48
2021-09-03T00:00:00.000Z,3745,6039754,64.95,4095,5537142,59.54,58865,2566067,27.59,0,0,0,61.56,0.03,38.42
2021-09-04T00:00:00.000Z,2692,6042446,64.98,2011,5539153,59.57,29934,2596001,27.92,0,0,0,61.59,0.03,38.38
2021-09-05T00:00:00.000Z,7003,6049449,65.05,6449,5545602,59.63,73295,2669296,28.7,0,0,0,61.68,0.03,38.29
2021-09-06T00:00:00.000Z,2821,6052270,65.08,2690,5548292,59.66,22785,2692081,28.95,0,0,0,61.77,0.03,38.2
2021-09-07T00:00:00.000Z,1189,6053459,65.1,865,5549157,59.67,5388,2697469,29.01,0,0,0,61.85,0.03,38.12
2021-09-08T00:00:00.000Z,1375,6054834,65.11,1175,5550332,59.69,6611,2704080,29.08,0,0,0,61.93,0.03,38.05
2021-09-09T00:00:00.000Z,7096,6061930,65.19,12552,5562884,59.82,73815,2777895,29.87,0,0,0,62.02,0.03,37.95
2021-09-10T00:00:00.000Z,3248,6065178,65.22,4990,5567874,59.87,37920,2815815,30.28,0,0,0,62.06,0.03,37.91
2021-09-11T00:00:00.000Z,2104,6067282,65.24,2495,5570369,59.9,14806,2830621,30.44,0,0,0,62.08,0.03,37.89
2021-09-12T00:00:00.000Z,6114,6073396,65.31,8583,5578952,59.99,54102,2884723,31.02,0,0,0,62.16,0.03,37.81
2021-09-13T00:00:00.000Z,5610,6079006,65.37,8245,5587197,60.08,47951,2932674,31.54,0,0,0,62.15,0.03,37.82
2021-09-14T00:00:00.000Z,4955,6083961,65.42,7407,5594604,60.16,48829,2981503,32.06,0,0,0,62.2,0.03,37.77
2021-09-15T00:00:00.000Z,1741,6085702,65.44,2701,5597305,60.19,16675,2998178,32.24,0,0,0,62.25,0.03,37.72
2021-09-16T00:00:00.000Z,337,6086039,65.45,538,5597843,60.2,1741,2999919,32.26,0,0,0,62.37,0.03,37.6
2021-09-17T00:00:00.000Z,3675,6089714,65.49,7005,5604848,60.27,42878,3042797,32.72,0,0,0,62.42,0.03,37.54
2021-09-18T00:00:00.000Z,2250,6091964,65.51,2935,5607783,60.3,12779,3055576,32.86,0,0,0,62.45,0.03,37.52
2021-09-19T00:00:00.000Z,5947,6097911,65.57,10701,5618484,60.42,44312,3099888,33.33,0,0,0,62.55,0.03,37.42
2021-09-20T00:00:00.000Z,3236,6101147,65.61,4629,5623113,60.47,16690,3116578,33.51,0,0,0,62.63,0.03,37.34
2021-09-21T00:00:00.000Z,1329,6102476,65.62,2043,5625156,60.49,3471,3120049,33.55,0,0,0,62.69,0.03,37.28
2021-09-22T00:00:00.000Z,4254,6106730,65.67,7234,5632390,60.57,25054,3145103,33.82,0,0,0,62.72,0.03,37.25
2021-09-23T00:00:00.000Z,4383,6111113,65.72,5896,5638286,60.63,27818,3172921,34.12,0,0,0,62.75,0.03,37.22
2021-09-24T00:00:00.000Z,3197,6114310,65.75,4177,5642463,60.68,27707,3200628,34.42,0,0,0,62.82,0.03,37.15
2021-09-25T00:00:00.000Z,2074,6116384,65.77,2248,5644711,60.7,10433,3211061,34.53,0,0,0,62.85,0.03,37.12
2021-09-26T00:00:00.000Z,5613,6121997,65.83,5963,5650674,60.76,36249,3247310,34.92,0,0,0,62.96,0.03,37
2021-09-27T00:00:00.000Z,4695,6126692,65.88,4453,5655127,60.81,30433,3277743,35.25,0,0,0,63.02,0.03,36.94
2021-09-28T00:00:00.000Z,1463,6128155,65.9,1172,5656299,60.82,6242,3283985,35.31,0,0,0,63.06,0.04,36.91
2021-09-29T00:00:00.000Z,9622,6137777,66,8335,5664634,60.91,60300,3344285,35.96,0,0,0,63.13,0.03,36.84
2021-09-30T00:00:00.000Z,10961,6148738,66.12,8558,5673192,61.01,79682,3423967,36.82,0,0,0,63.18,0.03,36.79
2021-10-01T00:00:00.000Z,5114,6153852,66.18,3858,5677050,61.05,46511,3470478,37.32,0,0,0,63.23,0.03,36.73
2021-10-02T00:00:00.000Z,2861,6156713,66.21,2119,5679169,61.07,22417,3492895,37.56,0,0,0,63.26,0.03,36.71
2021-10-03T00:00:00.000Z,11666,6168379,66.33,7260,5686429,61.15,70711,3563606,38.32,0,0,0,63.35,0.03,36.62
2021-10-04T00:00:00.000Z,10315,6178694,66.44,6740,5693169,61.22,51877,3615483,38.88,0,0,0,63.4,0.03,36.57
2021-10-05T00:00:00.000Z,8445,6187139,66.53,5297,5698466,61.28,40461,3655944,39.31,0,0,0,63.41,0.03,36.55
2021-10-06T00:00:00.000Z,7541,6194680,66.61,4166,5702632,61.32,34111,3690055,39.68,0,0,0,63.52,0.03,36.45
2021-10-07T00:00:00.000Z,6886,6201566,66.69,3993,5706625,61.37,34032,3724087,40.05,0,0,0,63.63,0.03,36.34
2021-10-08T00:00:00.000Z,3087,6204653,66.72,2626,5709251,61.39,19224,3743311,40.25,0,0,0,63.68,0.03,36.29
2021-10-09T00:00:00.000Z,1335,6205988,66.74,1431,5710682,61.41,7429,3750740,40.33,0,0,0,63.71,0.03,36.26
2021-10-10T00:00:00.000Z,4674,6210662,66.79,3737,5714419,61.45,21502,3772242,40.56,0,0,0,63.82,0.04,36.14
2021-10-11T00:00:00.000Z,4291,6214953,66.83,2930,5717349,61.48,17252,3789494,40.75,0,0,0,63.91,0.04,36.05
2021-10-12T00:00:00.000Z,3967,6218920,66.88,2989,5720338,61.51,15343,3804837,40.92,0,0,0,63.99,0.05,35.96
2021-10-13T00:00:00.000Z,3482,6222402,66.91,2439,5722777,61.54,13561,3818398,41.06,0,0,0,64.09,0.05,35.86
2021-10-14T00:00:00.000Z,3865,6226267,66.95,2673,5725450,61.57,16542,3834940,41.24,0,0,0,64.19,0.06,35.75
2021-10-15T00:00:00.000Z,1692,6227959,66.97,1672,5727122,61.59,8991,3843931,41.34,0,0,0,64.23,0.07,35.7
2021-10-16T00:00:00.000Z,727,6228686,66.98,940,5728062,61.6,4027,3847958,41.38,0,0,0,64.25,0.08,35.67
2021-10-17T00:00:00.000Z,3089,6231775,67.01,2517,5730579,61.62,12780,3860738,41.52,0,0,0,64.36,0.09,35.56
2021-10-18T00:00:00.000Z,2451,6234226,67.04,1667,5732246,61.64,10053,3870791,41.62,0,0,0,64.43,0.1,35.47
2021-10-19T00:00:00.000Z,2384,6236610,67.07,1273,5733519,61.66,9279,3880070,41.72,0,0,0,64.49,0.1,35.4
2021-10-20T00:00:00.000Z,2428,6239038,67.09,2283,5735802,61.68,10076,3890146,41.83,0,0,0,64.14,0.52,35.34
2021-10-21T00:00:00.000Z,3022,6242060,67.12,3079,5738881,61.71,12138,3902284,41.96,0,0,0,54.23,10.41,35.36
2021-10-22T00:00:00.000Z,1272,6243332,67.14,1418,5740299,61.73,5808,3908092,42.03,0,0,0,54.36,10.26,35.38
2021-10-23T00:00:00.000Z,562,6243894,67.14,1255,5741554,61.74,2558,3910650,42.05,0,0,0,54.42,10.19,35.39
2021-10-24T00:00:00.000Z,2512,6246406,67.17,2650,5744204,61.77,9840,3920490,42.16,0,0,0,54.22,10.43,35.35
2021-10-25T00:00:00.000Z,2627,6249033,67.2,2731,5746935,61.8,8488,3928978,42.25,0,0,0,54.59,10.22,35.19
2021-10-26T00:00:00.000Z,2369,6251402,67.22,2037,5748972,61.82,8505,3937483,42.34,0,0,0,54.64,10.26,35.1
2021-10-27T00:00:00.000Z,2289,6253691,67.25,2548,5751520,61.85,7936,3945419,42.43,0,0,0,54.58,10.37,35.06
2021-10-28T00:00:00.000Z,2491,6256182,67.28,2756,5754276,61.88,8646,3954065,42.52,0,0,0,54.69,10.76,34.55
2021-10-29T00:00:00.000Z,886,6257068,67.29,1132,5755408,61.89,4113,3958178,42.56,0,0,0,54.73,10.75,34.52
2021-10-30T00:00:00.000Z,355,6257423,67.29,524,5755932,61.9,1702,3959880,42.58,0,0,0,54.68,10.81,34.52
2021-10-31T00:00:00.000Z,2258,6259681,67.31,2485,5758417,61.92,8237,3968117,42.67,0,0,0,54.83,10.7,34.47
2021-11-01T00:00:00.000Z,1732,6261413,67.33,2083,5760500,61.95,6451,3974568,42.74,0,0,0,54.95,10.63,34.42
2021-11-02T00:00:00.000Z,2018,6263431,67.35,2027,5762527,61.97,6266,3980834,42.81,0,0,0,54.89,10.69,34.42
2021-11-03T00:00:00.000Z,1753,6265184,67.37,1878,5764405,61.99,5536,3986370,42.87,0,0,0,54.86,10.75,34.39
2021-11-04T00:00:00.000Z,2102,6267286,67.4,2787,5767192,62.02,7102,3993472,42.94,0,0,0,54.85,10.81,34.33
2021-11-05T00:00:00.000Z,773,6268059,67.4,889,5768081,62.03,3448,3996920,42.98,0,0,0,54.85,10.83,34.32
2021-11-06T00:00:00.000Z,341,6268400,67.41,379,5768460,62.03,1367,3998287,43,0,0,0,54.82,10.86,34.32
2021-11-07T00:00:00.000Z,1582,6269982,67.42,1766,5770226,62.05,6119,4004406,43.06,0,0,0,54.92,10.8,34.28
2021-11-08T00:00:00.000Z,1513,6271495,67.44,1591,5771817,62.07,5387,4009793,43.12,0,0,0,55.01,10.75,34.24
2021-11-09T00:00:00.000Z,1420,6272915,67.46,1591,5773408,62.08,5313,4015106,43.18,0,0,0,55.05,10.74,34.21
2021-11-10T00:00:00.000Z,1418,6274333,67.47,1642,5775050,62.1,4761,4019867,43.23,0,0,0,55.08,10.73,34.19
2021-11-11T00:00:00.000Z,1629,6275962,67.49,1927,5776977,62.12,5681,4025548,43.29,0,0,0,55.15,10.69,34.15
2021-11-12T00:00:00.000Z,623,6276585,67.5,812,5777789,62.13,2894,4028442,43.32,0,0,0,55.17,10.69,34.14
2021-11-13T00:00:00.000Z,252,6276837,67.5,281,5778070,62.13,1115,4029557,43.33,0,0,0,55.14,10.72,34.14
2021-11-14T00:00:00.000Z,1538,6278375,67.51,1626,5779696,62.15,5100,4034657,43.39,0,0,0,55.21,10.68,34.11
2021-11-15T00:00:00.000Z,1265,6279640,67.53,1607,5781303,62.17,4755,4039412,43.44,0,0,0,55.28,10.63,34.09
2021-11-16T00:00:00.000Z,1268,6280908,67.54,1396,5782699,62.18,4324,4043736,43.48,0,0,0,55.32,10.62,34.07
2021-11-17T00:00:00.000Z,1193,6282101,67.55,1549,5784248,62.2,3885,4047621,43.53,0,0,0,55.35,10.6,34.05
2021-11-18T00:00:00.000Z,1355,6283456,67.57,1676,5785924,62.22,4988,4052609,43.58,0,0,0,55.41,10.58,34.02
2021-11-19T00:00:00.000Z,585,6284041,67.58,745,5786669,62.23,2431,4055040,43.61,0,0,0,55.42,10.57,34.01
2021-11-20T00:00:00.000Z,234,6284275,67.58,242,5786911,62.23,915,4055955,43.62,0,0,0,55.41,10.58,34
2021-11-21T00:00:00.000Z,1412,6285687,67.59,1525,5788436,62.25,4861,4060816,43.67,0,0,0,55.47,10.54,33.98
2021-11-22T00:00:00.000Z,1675,6287362,67.61,1509,5789945,62.26,4208,4065024,43.71,0,0,0,55.54,10.5,33.96
2021-11-23T00:00:00.000Z,8616,6295978,67.7,1666,5791611,62.28,3974,4068998,43.76,0,0,0,55.57,10.48,33.95
2021-11-24T00:00:00.000Z,9346,6305324,67.8,1303,5792914,62.29,3900,4072898,43.8,0,0,0,55.6,10.44,33.95
2021-11-25T00:00:00.000Z,9810,6315134,67.91,1585,5794499,62.31,4817,4077715,43.85,0,0,0,55.64,10.43,33.93
2021-11-26T00:00:00.000Z,5607,6320741,67.97,735,5795234,62.32,2756,4080471,43.88,0,0,0,55.63,10.45,33.92
2021-11-27T00:00:00.000Z,4777,6325518,68.02,316,5795550,62.32,1146,4081617,43.89,0,0,0,55.62,10.46,33.92
2021-11-28T00:00:00.000Z,10145,6335663,68.13,1476,5797026,62.34,4884,4086501,43.94,0,0,0,55.67,10.43,33.9
2021-11-29T00:00:00.000Z,9037,6344700,68.23,1125,5798151,62.35,4343,4090844,43.99,0,0,0,55.73,10.39,33.88
2021-11-30T00:00:00.000Z,10043,6354743,68.34,1015,5799166,62.36,4052,4094896,44.03,0,0,0,55.77,10.37,33.86
2021-12-01T00:00:00.000Z,8622,6363365,68.43,1086,5800252,62.37,4411,4099307,44.08,2,2,0,55.79,10.36,33.84
2021-12-02T00:00:00.000Z,9169,6372534,68.53,1434,5801686,62.39,5086,4104393,44.14,6,8,0,55.84,10.34,33.82
2021-12-03T00:00:00.000Z,6333,6378867,68.6,658,5802344,62.4,2840,4107233,44.17,1,9,0,55.86,10.33,33.81
2021-12-04T00:00:00.000Z,2506,6381373,68.62,231,5802575,62.4,904,4108137,44.18,2,11,0,55.85,10.34,33.81
2021-12-05T00:00:00.000Z,8335,6389708,68.71,1250,5803825,62.41,4665,4112802,44.23,0,11,0,55.9,10.31,33.79
2021-12-06T00:00:00.000Z,6722,6396430,68.78,1185,5805010,62.42,4318,4117120,44.27,3,14,0,55.95,10.27,33.78
2021-12-07T00:00:00.000Z,5549,6401979,68.84,1489,5806499,62.44,3941,4121061,44.32,5,19,0,55.99,10.25,33.76
2021-12-08T00:00:00.000Z,4931,6406910,68.9,1188,5807687,62.45,3846,4124907,44.36,7,26,0,56.03,10.22,33.75
2021-12-09T00:00:00.000Z,6238,6413148,68.96,1223,5808910,62.47,4481,4129388,44.41,7,33,0,56.08,10.19,33.73
2021-12-10T00:00:00.000Z,3005,6416153,69,679,5809589,62.47,2651,4132039,44.43,3,36,0,56.1,10.18,33.72
2021-12-11T00:00:00.000Z,1491,6417644,69.01,250,5809839,62.48,999,4133038,44.44,0,36,0,56.1,10.18,33.71
2021-12-12T00:00:00.000Z,7273,6424917,69.09,1436,5811275,62.49,5230,4138268,44.5,2,38,0,56.16,10.15,33.69
2021-12-13T00:00:00.000Z,6176,6431093,69.16,1362,5812637,62.51,4324,4142592,44.55,2,40,0,56.21,10.11,33.67
2021-12-14T00:00:00.000Z,7319,6438412,69.24,6093,5818730,62.57,4909,4147501,44.6,10,50,0,56.27,10.09,33.65
2021-12-15T00:00:00.000Z,7201,6445613,69.31,7397,5826127,62.65,5414,4152915,44.66,2,52,0,56.34,10.06,33.6
2021-12-16T00:00:00.000Z,8080,6453693,69.4,8603,5834730,62.74,6521,4159436,44.73,5,57,0,56.53,10.05,33.42
2021-12-17T00:00:00.000Z,4398,6458091,69.45,5123,5839853,62.8,3908,4163344,44.77,3,60,0,56.64,10.05,33.3
2021-12-18T00:00:00.000Z,3937,6462028,69.49,2907,5842760,62.83,1340,4164684,44.79,2,62,0,56.73,10.07,33.2
2021-12-19T00:00:00.000Z,6983,6469011,69.56,9327,5852087,62.93,6250,4170934,44.85,2,64,0,56.92,10.04,33.04
2021-12-20T00:00:00.000Z,7972,6476983,69.65,7509,5859596,63.01,5396,4176330,44.91,7,71,0,57.07,10.02,32.91
2021-12-21T00:00:00.000Z,9548,6486531,69.75,8642,5868238,63.1,6436,4182766,44.98,5,76,0,57.27,10.01,32.71
2021-12-22T00:00:00.000Z,9665,6496196,69.86,8137,5876375,63.19,6212,4188978,45.05,10,86,0,57.49,10,32.52
2021-12-23T00:00:00.000Z,11543,6507739,69.98,10258,5886633,63.3,8101,4197079,45.13,13,99,0,57.7,9.97,32.33
2021-12-24T00:00:00.000Z,5878,6513617,70.04,6237,5892870,63.37,5237,4202316,45.19,6,105,0,57.83,9.96,32.21
2021-12-25T00:00:00.000Z,3338,6516955,70.08,2565,5895435,63.4,2016,4204332,45.21,5,110,0,57.9,9.96,32.15
2021-12-26T00:00:00.000Z,10654,6527609,70.19,8912,5904347,63.49,8181,4212513,45.3,7,117,0,58.1,9.92,31.98
2021-12-27T00:00:00.000Z,10367,6537976,70.31,7137,5911484,63.57,8159,4220672,45.39,17,134,0,58.27,9.9,31.83
2021-12-28T00:00:00.000Z,11373,6549349,70.43,7440,5918924,63.65,9608,4230280,45.49,15,149,0,58.46,9.88,31.66
2021-12-29T00:00:00.000Z,9944,6559293,70.54,5957,5924881,63.71,8334,4238614,45.58,11,160,0,58.64,9.85,31.51
2021-12-30T00:00:00.000Z,11016,6570309,70.65,7726,5932607,63.8,12213,4250827,45.71,7,167,0,58.84,9.82,31.34
2021-12-31T00:00:00.000Z,4833,6575142,70.71,3669,5936276,63.84,7280,4258107,45.79,128,295,0,58.9,9.79,31.3
2022-01-01T00:00:00.000Z,1991,6577133,70.73,1590,5937866,63.85,2738,4260845,45.82,60,355,0,58.93,9.79,31.28
2022-01-02T00:00:00.000Z,10217,6587350,70.84,6484,5944350,63.92,12992,4273837,45.96,588,943,0.01,59.14,9.76,31.1
2022-01-03T00:00:00.000Z,9386,6596736,70.94,5251,5949601,63.98,11305,4285142,46.08,25052,25995,0.28,59.29,9.71,31
2022-01-04T00:00:00.000Z,8969,6605705,71.03,5941,5955542,64.04,10492,4295634,46.19,50636,76631,0.82,59.46,9.68,30.86
2022-01-05T00:00:00.000Z,8552,6614257,71.13,5733,5961275,64.1,10454,4306088,46.31,59559,136190,1.46,59.56,9.65,30.79
2022-01-06T00:00:00.000Z,10342,6624599,71.24,7958,5969233,64.19,13508,4319596,46.45,63964,200154,2.15,59.81,9.63,30.56
2022-01-07T00:00:00.000Z,4753,6629352,71.29,4549,5973782,64.24,8123,4327719,46.54,31124,231278,2.49,59.89,9.61,30.49
2022-01-08T00:00:00.000Z,2749,6632101,71.32,2451,5976233,64.27,5479,4333198,46.6,27622,258900,2.78,59.9,9.64,30.46
2022-01-09T00:00:00.000Z,9313,6641414,71.42,7725,5983958,64.35,11850,4345048,46.72,66741,325641,3.5,60.06,9.59,30.35
2022-01-10T00:00:00.000Z,8362,6649776,71.51,7649,5991607,64.43,11843,4356891,46.85,64737,390378,4.2,60.21,9.54,30.25
2022-01-11T00:00:00.000Z,8106,6657882,71.6,8620,6000227,64.52,11943,4368834,46.98,56629,447007,4.81,60.38,9.49,30.13
2022-01-12T00:00:00.000Z,7278,6665160,71.67,8314,6008541,64.61,11083,4379917,47.1,44592,491599,5.29,60.51,9.45,30.04
2022-01-13T00:00:00.000Z,7514,6672674,71.75,9618,6018159,64.72,11512,4391429,47.22,34734,526333,5.66,60.7,9.35,29.94
2022-01-14T00:00:00.000Z,2556,6675230,71.78,4930,6023089,64.77,6123,4397552,47.29,11135,537468,5.78,60.79,9.31,29.9
2022-01-15T00:00:00.000Z,1462,6676692,71.8,3163,6026252,64.8,3860,4401412,47.33,5713,543181,5.84,60.83,9.29,29.87
2022-01-16T00:00:00.000Z,3820,6680512,71.84,8520,6034772,64.89,7665,4409077,47.41,19981,563162,6.06,60.97,9.2,29.82
2022-01-17T00:00:00.000Z,2809,6683321,71.87,7042,6041814,64.97,6149,4415226,47.48,17832,580994,6.25,61.09,9.13,29.78
2022-01-18T00:00:00.000Z,2474,6685795,71.9,7374,6049188,65.05,5498,4420724,47.54,14807,595801,6.41,61.23,9.07,29.7
2022-01-19T00:00:00.000Z,1915,6687710,71.92,6360,6055548,65.12,4497,4425221,47.59,8450,604251,6.5,61.37,8.98,29.65
2022-01-20T00:00:00.000Z,1778,6689488,71.94,6961,6062509,65.19,4768,4429989,47.64,8033,612284,6.58,61.44,8.85,29.71
2022-01-21T00:00:00.000Z,899,6690387,71.95,3726,6066235,65.23,2618,4432607,47.67,3353,615637,6.62,61.51,8.81,29.68
2022-01-22T00:00:00.000Z,329,6690716,71.95,1457,6067692,65.25,1047,4433654,47.68,1110,616747,6.63,61.51,8.75,29.74
2022-01-23T00:00:00.000Z,1066,6691782,71.96,5624,6073316,65.31,2866,4436520,47.71,6077,622824,6.7,61.61,8.7,29.69
2022-01-24T00:00:00.000Z,756,6692538,71.97,4480,6077796,65.36,2244,4438764,47.73,5050,627874,6.75,61.73,8.62,29.65
2022-01-25T00:00:00.000Z,741,6693279,71.98,4397,6082193,65.4,2163,4440927,47.76,7097,634971,6.83,61.9,8.51,29.59
2022-01-26T00:00:00.000Z,613,6693892,71.98,3283,6085476,65.44,1591,4442518,47.77,4258,639229,6.87,62.02,8.42,29.57
2022-01-27T00:00:00.000Z,792,6694684,71.99,4401,6089877,65.49,1980,4444498,47.79,5435,644664,6.93,62.12,8.35,29.52
2022-01-28T00:00:00.000Z,394,6695078,72,2374,6092251,65.51,1154,4445652,47.81,3443,648107,6.97,62.16,8.33,29.5
2022-01-29T00:00:00.000Z,124,6695202,72,1042,6093293,65.52,413,4446065,47.81,1158,649265,6.98,62.23,8.29,29.48
2022-01-30T00:00:00.000Z,767,6695969,72.01,4716,6098009,65.58,2008,4448073,47.83,8098,657363,7.07,62.3,8.24,29.46
2022-01-31T00:00:00.000Z,528,6696497,72.01,3181,6101190,65.61,1595,4449668,47.85,6465,663828,7.14,62.39,8.17,29.43
2022-02-01T00:00:00.000Z,478,6696975,72.02,2796,6103986,65.64,1498,4451166,47.87,5714,669542,7.2,62.45,8.15,29.4
2022-02-02T00:00:00.000Z,374,6697349,72.02,2382,6106368,65.66,1365,4452531,47.88,5067,674609,7.25,62.28,8.13,29.59
2022-02-03T00:00:00.000Z,445,6697794,72.02,2774,6109142,65.69,1443,4453974,47.9,5601,680210,7.31,62.34,8.08,29.57
2022-02-04T00:00:00.000Z,174,6697968,72.03,985,6110127,65.71,741,4454715,47.9,2449,682659,7.34,62.37,8.06,29.57
2022-02-05T00:00:00.000Z,59,6698027,72.03,339,6110466,65.71,207,4454922,47.91,418,683077,7.35,62.34,8.09,29.56
2022-02-06T00:00:00.000Z,407,6698434,72.03,2317,6112783,65.73,1335,4456257,47.92,5676,688753,7.41,62.41,8.05,29.55
2022-02-07T00:00:00.000Z,280,6698714,72.03,1307,6114090,65.75,966,4457223,47.93,5955,694708,7.47,62.47,8.01,29.52
2022-02-08T00:00:00.000Z,313,6699027,72.04,1494,6115584,65.76,1051,4458274,47.94,6130,700838,7.54,62.54,7.97,29.49
2022-02-09T00:00:00.000Z,252,6699279,72.04,1100,6116684,65.78,926,4459200,47.95,4568,705406,7.59,62.6,7.95,29.45
2022-02-10T00:00:00.000Z,269,6699548,72.04,1291,6117975,65.79,921,4460121,47.96,4812,710218,7.64,62.63,7.93,29.44
2022-02-11T00:00:00.000Z,194,6699742,72.05,542,6118517,65.8,505,4460626,47.97,2529,712747,7.66,62.67,7.91,29.42
2022-02-12T00:00:00.000Z,27,6699769,72.05,90,6118607,65.8,115,4460741,47.97,262,713009,7.67,62.67,7.91,29.41
2022-02-13T00:00:00.000Z,286,6700055,72.05,945,6119552,65.81,962,4461703,47.98,4993,718002,7.72,62.73,7.87,29.39
2022-02-14T00:00:00.000Z,179,6700234,72.05,624,6120176,65.81,741,4462444,47.99,3134,721136,7.75,62.89,7.74,29.36
2022-02-15T00:00:00.000Z,266,6700500,72.05,763,6120939,65.82,918,4463362,48,3813,724949,7.8,62.92,7.73,29.35
2022-02-16T00:00:00.000Z,179,6700679,72.06,575,6121514,65.83,796,4464158,48.01,2482,727431,7.82,62.95,7.72,29.34
2022-02-17T00:00:00.000Z,248,6700927,72.06,738,6122252,65.84,765,4464923,48.01,3049,730480,7.86,62.96,7.7,29.34
2022-02-18T00:00:00.000Z,127,6701054,72.06,326,6122578,65.84,426,4465349,48.02,1112,731592,7.87,62.98,7.69,29.33
2022-02-19T00:00:00.000Z,33,6701087,72.06,82,6122660,65.84,73,4465422,48.02,76,731668,7.87,62.99,7.69,29.32
2022-02-20T00:00:00.000Z,203,6701290,72.06,603,6123263,65.85,714,4466136,48.03,2563,734231,7.9,63.01,7.67,29.32
2022-02-21T00:00:00.000Z,173,6701463,72.06,411,6123674,65.85,477,4466613,48.03,1538,735769,7.91,63.04,7.65,29.31
2022-02-22T00:00:00.000Z,155,6701618,72.07,451,6124125,65.86,556,4467169,48.04,1864,737633,7.93,63.05,7.65,29.3
2022-02-23T00:00:00.000Z,109,6701727,72.07,351,6124476,65.86,450,4467619,48.04,1152,738785,7.94,63.06,7.65,29.29
2022-02-24T00:00:00.000Z,137,6701864,72.07,454,6124930,65.86,559,4468178,48.05,1488,740273,7.96,63.05,7.66,29.29
2022-02-25T00:00:00.000Z,58,6701922,72.07,137,6125067,65.87,186,4468364,48.05,454,740727,7.97,63.06,7.66,29.28
2022-02-26T00:00:00.000Z,15,6701937,72.07,26,6125093,65.87,149,4468513,48.05,34,740761,7.97,63.05,7.67,29.28
2022-02-27T00:00:00.000Z,112,6702049,72.07,339,6125432,65.87,447,4468960,48.06,1118,741879,7.98,63.05,7.67,29.28
2022-02-28T00:00:00.000Z,108,6702157,72.07,264,6125696,65.87,410,4469370,48.06,903,742782,7.99,63.07,7.65,29.28
2022-03-01T00:00:00.000Z,97,6702254,72.07,278,6125974,65.88,362,4469732,48.07,792,743574,8,63.1,7.63,29.27
2022-03-02T00:00:00.000Z,74,6702328,72.07,200,6126174,65.88,318,4470050,48.07,691,744265,8,63.11,7.62,29.27
2022-03-03T00:00:00.000Z,147,6702475,72.08,368,6126542,65.88,493,4470543,48.07,983,745248,8.01,63.05,7.67,29.27
2022-03-04T00:00:00.000Z,51,6702526,72.08,158,6126700,65.88,163,4470706,48.08,226,745474,8.02,63.05,7.68,29.27
2022-03-05T00:00:00.000Z,1,6702527,72.08,24,6126724,65.88,43,4470749,48.08,30,745504,8.02,63.04,7.69,29.27
2022-03-06T00:00:00.000Z,96,6702623,72.08,258,6126982,65.89,411,4471160,48.08,759,746263,8.02,63.04,7.69,29.27
2022-03-07T00:00:00.000Z,88,6702711,72.08,255,6127237,65.89,345,4471505,48.08,603,746866,8.03,63.05,7.69,29.26
2022-03-08T00:00:00.000Z,98,6702809,72.08,263,6127500,65.89,330,4471835,48.09,546,747412,8.04,63.04,7.7,29.26
2022-03-09T00:00:00.000Z,88,6702897,72.08,212,6127712,65.89,332,4472167,48.09,490,747902,8.04,63.02,7.72,29.25
2022-03-10T00:00:00.000Z,113,6703010,72.08,372,6128084,65.9,419,4472586,48.1,614,748516,8.05,63.01,7.74,29.25
2022-03-11T00:00:00.000Z,24,6703034,72.08,85,6128169,65.9,116,4472702,48.1,141,748657,8.05,63,7.75,29.25
2022-03-12T00:00:00.000Z,7,6703041,72.08,9,6128178,65.9,27,4472729,48.1,27,748684,8.05,62.98,7.77,29.24
2022-03-13T00:00:00.000Z,94,6703135,72.08,270,6128448,65.9,357,4473086,48.1,594,749278,8.06,62.98,7.78,29.24
2022-03-14T00:00:00.000Z,64,6703199,72.08,250,6128698,65.91,316,4473402,48.1,558,749836,8.06,62.98,7.78,29.24
2022-03-15T00:00:00.000Z,77,6703276,72.08,182,6128880,65.91,286,4473688,48.11,581,750417,8.07,62.95,7.81,29.24
2022-03-16T00:00:00.000Z,74,6703350,72.08,205,6129085,65.91,301,4473989,48.11,668,751085,8.08,62.94,7.82,29.24
2022-03-17T00:00:00.000Z,65,6703415,72.09,120,6129205,65.91,283,4474272,48.11,607,751692,8.08,62.94,7.82,29.24
2022-03-18T00:00:00.000Z,18,6703433,72.09,53,6129258,65.91,98,4474370,48.12,229,751921,8.09,62.94,7.82,29.24
2022-03-19T00:00:00.000Z,5,6703438,72.09,10,6129268,65.91,26,4474396,48.12,37,751958,8.09,62.89,7.88,29.23
2022-03-20T00:00:00.000Z,118,6703556,72.09,258,6129526,65.91,480,4474876,48.12,1425,753383,8.1,62.87,7.89,29.23
2022-03-21T00:00:00.000Z,97,6703653,72.09,243,6129769,65.92,373,4475249,48.12,1126,754509,8.11,62.87,7.9,29.23
2022-03-22T00:00:00.000Z,140,6703793,72.09,339,6130108,65.92,502,4475751,48.13,1767,756276,8.13,62.84,7.94,29.23
2022-03-23T00:00:00.000Z,108,6703901,72.09,210,6130318,65.92,457,4476208,48.13,1672,757948,8.15,62.81,7.97,29.22
2022-03-24T00:00:00.000Z,175,6704076,72.09,343,6130661,65.93,762,4476970,48.14,2358,760306,8.18,62.78,8,29.22
2022-03-25T00:00:00.000Z,36,6704112,72.09,77,6130738,65.93,152,4477122,48.14,624,760930,8.18,62.78,8,29.23
2022-03-26T00:00:00.000Z,11,6704123,72.09,11,6130749,65.93,32,4477154,48.15,89,761019,8.18,62.77,8,29.22
2022-03-27T00:00:00.000Z,159,6704282,72.09,343,6131092,65.93,756,4477910,48.15,3186,764205,8.22,62.75,8.02,29.22
2022-03-28T00:00:00.000Z,112,6704394,72.1,268,6131360,65.93,616,4478526,48.16,2399,766604,8.24,62.75,8.03,29.22
2022-03-29T00:00:00.000Z,125,6704519,72.1,259,6131619,65.94,634,4479160,48.17,2764,769368,8.27,62.7,8.07,29.22
2022-03-30T00:00:00.000Z,135,6704654,72.1,209,6131828,65.94,535,4479695,48.17,2361,771729,8.3,62.81,8.11,29.07
2022-03-31T00:00:00.000Z,166,6704820,72.1,292,6132120,65.94,727,4480422,48.18,2835,774564,8.33,62.79,8.11,29.1
2022-04-01T00:00:00.000Z,117,6704937,72.1,158,6132278,65.94,271,4480693,48.18,584,775148,8.34,62.72,8.13,29.15
2022-04-02T00:00:00.000Z,6,6704943,72.1,4,6132282,65.94,34,4480727,48.18,49,775197,8.34,62.69,8.15,29.16
2022-04-03T00:00:00.000Z,154,6705097,72.1,262,6132544,65.95,568,4481295,48.19,2469,777666,8.36,62.65,8.16,29.19
2022-04-04T00:00:00.000Z,104,6705201,72.1,204,6132748,65.95,479,4481774,48.19,2211,779877,8.39,62.62,8.16,29.22
2022-04-05T00:00:00.000Z,122,6705323,72.11,218,6132966,65.95,512,4482286,48.2,2232,782109,8.41,62.57,8.19,29.25
2022-04-06T00:00:00.000Z,91,6705414,72.11,151,6133117,65.95,378,4482664,48.2,2011,784120,8.43,62.55,8.2,29.25
2022-04-07T00:00:00.000Z,178,6705592,72.11,206,6133323,65.95,633,4483297,48.21,2548,786668,8.46,62.56,8.2,29.24
2022-04-08T00:00:00.000Z,28,6705620,72.11,55,6133378,65.96,148,4483445,48.21,466,787134,8.46,62.54,8.22,29.23
2022-04-09T00:00:00.000Z,6,6705626,72.11,15,6133393,65.96,24,4483469,48.21,41,787175,8.46,62.52,8.25,29.23
2022-04-10T00:00:00.000Z,103,6705729,72.11,257,6133650,65.96,423,4483892,48.22,1836,789011,8.48,62.51,8.26,29.23
2022-04-11T00:00:00.000Z,78,6705807,72.11,200,6133850,65.96,369,4484261,48.22,1414,790425,8.5,62.54,8.26,29.2
2022-04-12T00:00:00.000Z,203,6706010,72.11,163,6134013,65.96,367,4484628,48.23,1346,791771,8.51,62.58,8.29,29.12
2022-04-13T00:00:00.000Z,116,6706126,72.11,148,6134161,65.96,297,4484925,48.23,1213,792984,8.53,62.58,8.31,29.1
2022-04-14T00:00:00.000Z,81,6706207,72.12,221,6134382,65.97,318,4485243,48.23,1060,794044,8.54,62.57,8.33,29.1
2022-04-15T00:00:00.000Z,9,6706216,72.12,51,6134433,65.97,47,4485290,48.23,77,794121,8.54,62.55,8.35,29.1
2022-04-16T00:00:00.000Z,3,6706219,72.12,8,6134441,65.97,19,4485309,48.23,26,794147,8.54,62.53,8.37,29.1
2022-04-17T00:00:00.000Z,61,6706280,72.12,130,6134571,65.97,228,4485537,48.24,807,794954,8.55,62.52,8.38,29.1
2022-04-18T00:00:00.000Z,68,6706348,72.12,107,6134678,65.97,248,4485785,48.24,743,795697,8.56,62.51,8.38,29.1
2022-04-19T00:00:00.000Z,61,6706409,72.12,129,6134807,65.97,267,4486052,48.24,827,796524,8.57,62.5,8.4,29.1
2022-04-20T00:00:00.000Z,64,6706473,72.12,117,6134924,65.97,230,4486282,48.24,640,797164,8.57,62.48,8.42,29.1
2022-04-21T00:00:00.000Z,53,6706526,72.12,104,6135028,65.97,189,4486471,48.25,473,797637,8.58,62.47,8.43,29.1
2022-04-22T00:00:00.000Z,0,6706526,72.12,15,6135043,65.97,14,4486485,48.25,12,797649,8.58,62.45,8.44,29.11
2022-04-23T00:00:00.000Z,4,6706530,72.12,7,6135050,65.97,12,4486497,48.25,13,797662,8.58,62.43,8.46,29.11
2022-04-24T00:00:00.000Z,92,6706622,72.12,240,6135290,65.98,327,4486824,48.25,861,798523,8.59,62.43,8.47,29.1
2022-04-25T00:00:00.000Z,105,6706727,72.12,191,6135481,65.98,307,4487131,48.25,730,799253,8.59,62.43,8.47,29.1
2022-04-26T00:00:00.000Z,74,6706801,72.12,172,6135653,65.98,295,4487426,48.26,778,800031,8.6,62.42,8.48,29.1
2022-04-27T00:00:00.000Z,55,6706856,72.12,159,6135812,65.98,218,4487644,48.26,632,800663,8.61,62.41,8.49,29.1
2022-04-28T00:00:00.000Z,94,6706950,72.12,219,6136031,65.98,326,4487970,48.26,856,801519,8.62,62.41,8.5,29.1
2022-04-29T00:00:00.000Z,107,6707057,72.12,138,6136169,65.99,181,4488151,48.26,207,801726,8.62,62.39,8.51,29.1
2022-04-30T00:00:00.000Z,1,6707058,72.12,1,6136170,65.99,23,4488174,48.26,18,801744,8.62,62.38,8.52,29.1
2022-05-01T00:00:00.000Z,119,6707177,72.13,174,6136344,65.99,312,4488486,48.27,626,802370,8.63,62.38,8.53,29.09
2022-05-02T00:00:00.000Z,61,6707238,72.13,151,6136495,65.99,234,4488720,48.27,480,802850,8.63,62.37,8.54,29.09
2022-05-03T00:00:00.000Z,73,6707311,72.13,150,6136645,65.99,283,4489003,48.27,494,803344,8.64,62.36,8.55,29.09
2022-05-04T00:00:00.000Z,24,6707335,72.13,53,6136698,65.99,56,4489059,48.27,121,803465,8.64,62.35,8.57,29.08
2022-05-05T00:00:00.000Z,0,6707335,72.13,0,6136698,65.99,1,4489060,48.27,1,803466,8.64,62.34,8.58,29.08
2022-05-06T00:00:00.000Z,18,6707353,72.13,58,6136756,65.99,63,4489123,48.27,139,803605,8.64,62.33,8.59,29.08
2022-05-07T00:00:00.000Z,0,6707353,72.13,3,6136759,65.99,22,4489145,48.27,20,803625,8.64,62.32,8.6,29.08
2022-05-08T00:00:00.000Z,94,6707447,72.13,197,6136956,65.99,266,4489411,48.28,451,804076,8.65,62.31,8.61,29.08
2022-05-09T00:00:00.000Z,0,6707447,72.13,0,6136956,65.99,0,4489411,48.28,0,804076,8.65,62.31,8.61,29.08
