Day_Date,vaccinated,vaccinated_cum,vaccinated_population_perc,vaccinated_seconde_dose,vaccinated_seconde_dose_cum,vaccinated_seconde_dose_population_perc,vaccinated_third_dose,vaccinated_third_dose_cum,vaccinated_third_dose_population_perc,vaccinated_fourth_dose,vaccinated_fourth_dose_cum,vaccinated_fourth_dose_population_perc,vaccinated_validity_perc,vaccinated_expired_perc,not_vaccinated_perc
2020-12-19T00:00:00.000Z,46,70,0,0,4,0,0,0,0,0,0,0,0,0,100
2020-12-20T00:00:00.000Z,7393,7463,0.08,0,4,0,0,0,0,0,0,0,0,0,100
2020-12-21T00:00:00.000Z,24922,32385,0.35,0,4,0,0,0,0,0,0,0,0,0,100
2020-12-22T00:00:00.000Z,44662,77047,0.83,0,4,0,0,0,0,0,0,0,0,0,100
2020-12-23T00:00:00.000Z,62912,139959,1.51,0,4,0,0,0,0,0,0,0,0,0,100
2020-12-24T00:00:00.000Z,73423,213382,2.29,0,4,0,0,0,0,0,0,0,0,0,100
2020-12-25T00:00:00.000Z,38512,251894,2.71,0,4,0,0,0,0,0,0,0,0,0,100
2020-12-26T00:00:00.000Z,32615,284509,3.06,0,4,0,0,0,0,0,0,0,0,0,100
2020-12-27T00:00:00.000Z,104562,389071,4.18,0,4,0,0,0,0,0,0,0,0,0,100
2020-12-28T00:00:00.000Z,135015,524086,5.64,0,4,0,0,0,0,0,0,0,0,0,100
2020-12-29T00:00:00.000Z,156304,680390,7.32,2,6,0,0,0,0,0,0,0,0,0,100
2020-12-30T00:00:00.000Z,153158,833548,8.96,0,6,0,0,0,0,0,0,0,0,0,100
2020-12-31T00:00:00.000Z,158561,992109,10.67,0,6,0,0,0,0,0,0,0,0,0,100
2021-01-01T00:00:00.000Z,71424,1063533,11.44,0,6,0,0,0,0,0,0,0,0,0,100
2021-01-02T00:00:00.000Z,71734,1135267,12.21,0,6,0,0,0,0,0,0,0,0,0,100
2021-01-03T00:00:00.000Z,149748,1285015,13.82,0,6,0,0,0,0,0,0,0,0,0,100
2021-01-04T00:00:00.000Z,152178,1437193,15.45,1,7,0,0,0,0,0,0,0,0,0,100
2021-01-05T00:00:00.000Z,125190,1562383,16.8,4,11,0,0,0,0,0,0,0,0,0,100
2021-01-06T00:00:00.000Z,103350,1665733,17.91,2,13,0,0,0,0,0,0,0,0,0,100
2021-01-07T00:00:00.000Z,116034,1781767,19.16,9,22,0,0,0,0,0,0,0,0,0,100
2021-01-08T00:00:00.000Z,66450,1848217,19.87,4,26,0,0,0,0,0,0,0,0,0,100
2021-01-09T00:00:00.000Z,44541,1892758,20.35,24,50,0,0,0,0,0,0,0,0,0,100
2021-01-10T00:00:00.000Z,37641,1930399,20.76,5999,6049,0.07,0,0,0,0,0,0,0,0,100
2021-01-11T00:00:00.000Z,21165,1951564,20.99,19263,25312,0.27,0,0,0,0,0,0,0,0,100
2021-01-12T00:00:00.000Z,24067,1975631,21.25,35671,60983,0.66,0,0,0,0,0,0,0,0,100
2021-01-13T00:00:00.000Z,52064,2027695,21.8,56870,117853,1.27,0,0,0,0,0,0,0,0,100
2021-01-14T00:00:00.000Z,56466,2084161,22.41,68833,186686,2.01,0,0,0,0,0,0,0,0,100
2021-01-15T00:00:00.000Z,30765,2114926,22.74,35938,222624,2.39,0,0,0,0,0,0,0,0,100
2021-01-16T00:00:00.000Z,29477,2144403,23.06,26004,248628,2.67,0,0,0,0,0,0,0,0,100
2021-01-17T00:00:00.000Z,68427,2212830,23.8,84590,333218,3.58,0,0,0,0,0,0,0.31,0,99.69
2021-01-18T00:00:00.000Z,69809,2282639,24.55,120421,453639,4.88,0,0,0,0,0,0,0.58,0,99.42
2021-01-19T00:00:00.000Z,72885,2355524,25.33,137825,591464,6.36,0,0,0,0,0,0,1.09,0,98.91
2021-01-20T00:00:00.000Z,76897,2432421,26.16,143752,735216,7.91,0,0,0,0,0,0,1.9,0,98.1
2021-01-21T00:00:00.000Z,69987,2502408,26.91,164441,899657,9.67,0,0,0,0,0,0,2.88,0,97.12
2021-01-22T00:00:00.000Z,37917,2540325,27.32,71127,970784,10.44,0,0,0,0,0,0,3.39,0,96.61
2021-01-23T00:00:00.000Z,39962,2580287,27.75,53581,1024365,11.02,0,0,0,0,0,0,3.77,0,96.23
2021-01-24T00:00:00.000Z,69138,2649425,28.49,140694,1165059,12.53,0,0,0,0,0,0,4.96,0,95.04
2021-01-25T00:00:00.000Z,80934,2730359,29.36,139503,1304562,14.03,0,0,0,0,0,0,6.61,0,93.39
2021-01-26T00:00:00.000Z,78715,2809074,30.21,126422,1430984,15.39,0,0,0,0,0,0,8.45,0,91.55
2021-01-27T00:00:00.000Z,77966,2887040,31.05,125053,1556037,16.73,0,0,0,0,0,0,10.34,0,89.66
2021-01-28T00:00:00.000Z,79563,2966603,31.9,130607,1686644,18.14,0,0,0,0,0,0,12.43,0,87.57
2021-01-29T00:00:00.000Z,36695,3003298,32.3,64784,1751428,18.83,0,0,0,0,0,0,13.34,0,86.66
2021-01-30T00:00:00.000Z,34392,3037690,32.67,42759,1794187,19.29,0,0,0,0,0,0,14.02,0,85.98
2021-01-31T00:00:00.000Z,73324,3111014,33.45,59493,1853680,19.93,0,0,0,0,0,0,15.76,0,84.24
2021-02-01T00:00:00.000Z,82493,3193507,34.34,35348,1889028,20.31,0,0,0,0,0,0,17.48,0,82.52
2021-02-02T00:00:00.000Z,70088,3263595,35.1,31062,1920090,20.65,0,0,0,0,0,0,19.01,0,80.99
2021-02-03T00:00:00.000Z,60303,3323898,35.74,51434,1971524,21.2,0,0,0,0,0,0,20.47,0,79.53
2021-02-04T00:00:00.000Z,72617,3396515,36.52,58086,2029610,21.83,0,0,0,0,0,0,22,0,78
2021-02-05T00:00:00.000Z,33939,3430454,36.89,28799,2058409,22.14,0,0,0,0,0,0,22.75,0,77.25
2021-02-06T00:00:00.000Z,21618,3452072,37.12,22228,2080637,22.37,0,0,0,0,0,0,23.23,0,76.77
2021-02-07T00:00:00.000Z,54075,3506147,37.7,68727,2149364,23.11,0,0,0,0,0,0,23.99,0,76.01
2021-02-08T00:00:00.000Z,58631,3564778,38.33,65457,2214821,23.82,0,0,0,0,0,0,24.52,0,75.48
2021-02-09T00:00:00.000Z,66339,3631117,39.05,67566,2282387,24.54,0,0,0,0,0,0,25.04,0,74.96
2021-02-10T00:00:00.000Z,70560,3701677,39.81,72300,2354687,25.32,0,0,0,0,0,0,25.77,0,74.23
2021-02-11T00:00:00.000Z,81154,3782831,40.68,72096,2426783,26.1,0,0,0,0,0,0,26.61,0,73.39
2021-02-12T00:00:00.000Z,39093,3821924,41.1,37587,2464370,26.5,0,0,0,0,0,0,27.02,0,72.98
2021-02-13T00:00:00.000Z,27458,3849382,41.39,30439,2494809,26.83,0,0,0,0,0,0,27.33,0,72.67
2021-02-14T00:00:00.000Z,74909,3924291,42.2,69077,2563886,27.57,0,0,0,0,0,0,28.25,0,71.75
2021-02-15T00:00:00.000Z,81538,4005829,43.08,75714,2639600,28.38,0,0,0,0,0,0,29.17,0,70.83
2021-02-16T00:00:00.000Z,83412,4089241,43.97,78284,2717884,29.23,0,0,0,0,0,0,30.11,0,69.89
2021-02-17T00:00:00.000Z,61974,4151215,44.64,75633,2793517,30.04,0,0,0,0,0,0,31.01,0,68.99
2021-02-18T00:00:00.000Z,69147,4220362,45.38,79728,2873245,30.9,0,0,0,0,0,0,31.94,0,68.06
2021-02-19T00:00:00.000Z,39665,4260027,45.81,38151,2911396,31.31,0,0,0,0,0,0,32.45,0,67.55
2021-02-20T00:00:00.000Z,31648,4291675,46.15,28723,2940119,31.62,0,0,0,0,0,0,32.85,0,67.15
2021-02-21T00:00:00.000Z,79427,4371102,47,78440,3018559,32.46,0,0,0,0,0,0,33.8,0,66.2
2021-02-22T00:00:00.000Z,85054,4456156,47.92,80587,3099146,33.33,0,0,0,0,0,0,34.83,0,65.17
2021-02-23T00:00:00.000Z,77320,4533476,48.75,70472,3169618,34.08,0,0,0,0,0,0,35.84,0,64.16
2021-02-24T00:00:00.000Z,61064,4594540,49.41,63136,3232754,34.76,0,0,0,0,0,0,36.76,0,63.24
2021-02-25T00:00:00.000Z,51724,4646264,49.96,64797,3297551,35.46,0,0,0,0,0,0,37.66,0,62.34
2021-02-26T00:00:00.000Z,25905,4672169,50.24,32037,3329588,35.8,0,0,0,0,0,0,38.1,0,61.9
2021-02-27T00:00:00.000Z,18347,4690516,50.44,21195,3350783,36.03,0,0,0,0,0,0,38.42,0,61.58
2021-02-28T00:00:00.000Z,40356,4730872,50.87,55869,3406652,36.63,0,0,0,0,0,0,39.24,0,60.76
2021-03-01T00:00:00.000Z,45738,4776610,51.37,61433,3468085,37.29,0,0,0,0,0,0,40.1,0,59.9
2021-03-02T00:00:00.000Z,41195,4817805,51.81,64790,3532875,37.99,0,0,0,0,0,0,40.85,0,59.15
2021-03-03T00:00:00.000Z,42019,4859824,52.26,66785,3599660,38.71,0,0,0,0,0,0,41.55,0,58.45
2021-03-04T00:00:00.000Z,39707,4899531,52.69,79110,3678770,39.56,0,0,0,0,0,0,42.24,0,57.76
2021-03-05T00:00:00.000Z,17358,4916889,52.87,40460,3719230,39.99,0,0,0,0,0,0,42.57,0,57.43
2021-03-06T00:00:00.000Z,10716,4927605,52.99,25342,3744572,40.27,0,0,0,0,0,0,42.78,0,57.22
2021-03-07T00:00:00.000Z,31151,4958756,53.32,72837,3817409,41.05,0,0,0,0,0,0,43.36,0,56.64
2021-03-08T00:00:00.000Z,27379,4986135,53.62,73289,3890698,41.84,0,0,0,0,0,0,43.97,0,56.03
2021-03-09T00:00:00.000Z,26746,5012881,53.91,76595,3967293,42.66,0,0,0,0,0,0,44.62,0,55.38
2021-03-10T00:00:00.000Z,23361,5036242,54.16,58678,4025971,43.29,0,0,0,0,0,0,45.27,0,54.73
2021-03-11T00:00:00.000Z,23295,5059537,54.41,69083,4095054,44.04,0,0,0,0,0,0,45.99,0,54.01
2021-03-12T00:00:00.000Z,11290,5070827,54.53,41407,4136461,44.48,0,0,0,0,0,0,46.34,0,53.66
2021-03-13T00:00:00.000Z,7945,5078772,54.61,25236,4161697,44.75,0,0,0,0,0,0,46.57,0,53.43
2021-03-14T00:00:00.000Z,20982,5099754,54.84,73930,4235627,45.55,0,0,0,0,0,0,47.2,0,52.8
2021-03-15T00:00:00.000Z,20138,5119892,55.06,78276,4313903,46.39,0,0,0,0,0,0,47.81,0,52.19
2021-03-16T00:00:00.000Z,18749,5138641,55.26,71473,4385376,47.16,0,0,0,0,0,0,48.43,0,51.57
2021-03-17T00:00:00.000Z,17697,5156338,55.45,59000,4444376,47.79,0,0,0,0,0,0,48.92,0,51.08
2021-03-18T00:00:00.000Z,16043,5172381,55.62,58125,4502501,48.42,0,0,0,0,0,0,49.45,0,50.55
2021-03-19T00:00:00.000Z,6947,5179328,55.7,27974,4530475,48.72,0,0,0,0,0,0,49.75,0,50.25
2021-03-20T00:00:00.000Z,5223,5184551,55.75,15296,4545771,48.88,0,0,0,0,0,0,49.93,0,50.07
2021-03-21T00:00:00.000Z,13165,5197716,55.89,40503,4586274,49.32,0,0,0,0,0,0,50.46,0,49.54
2021-03-22T00:00:00.000Z,13570,5211286,56.04,40533,4626807,49.75,0,0,0,0,0,0,51,0,49
2021-03-23T00:00:00.000Z,2837,5214123,56.07,7297,4634104,49.83,0,0,0,0,0,0,51.43,0,48.57
2021-03-24T00:00:00.000Z,10989,5225112,56.19,46551,4680655,50.33,0,0,0,0,0,0,51.84,0,48.16
2021-03-25T00:00:00.000Z,10257,5235369,56.3,35430,4716085,50.71,0,0,0,0,0,0,52.22,0,47.78
2021-03-26T00:00:00.000Z,4180,5239549,56.34,13327,4729412,50.86,0,0,0,0,0,0,52.4,0,47.6
2021-03-27T00:00:00.000Z,1784,5241333,56.36,4265,4733677,50.9,0,0,0,0,0,0,52.5,0,47.5
2021-03-28T00:00:00.000Z,2109,5243442,56.39,4606,4738283,50.95,0,0,0,0,0,0,52.74,0,47.26
2021-03-29T00:00:00.000Z,6904,5250346,56.46,30014,4768297,51.28,0,0,0,0,0,0,53,0,47
2021-03-30T00:00:00.000Z,7883,5258229,56.54,22446,4790743,51.52,0,0,0,0,0,0,53.08,0,46.92
2021-03-31T00:00:00.000Z,8146,5266375,56.63,19488,4810231,51.73,0,0,0,0,0,0,53.38,0,46.62
2021-04-01T00:00:00.000Z,8196,5274571,56.72,18698,4828929,51.93,0,0,0,0,0,0,53.62,0,46.38
2021-04-02T00:00:00.000Z,2927,5277498,56.75,8126,4837055,52.02,0,0,0,0,0,0,53.71,0,46.29
2021-04-03T00:00:00.000Z,1431,5278929,56.77,2976,4840031,52.05,0,0,0,0,0,0,53.74,0,46.26
2021-04-04T00:00:00.000Z,9616,5288545,56.87,22830,4862861,52.29,0,0,0,0,0,0,53.82,0,46.18
2021-04-05T00:00:00.000Z,10356,5298901,56.98,21268,4884129,52.52,0,0,0,0,0,0,54.04,0,45.96
2021-04-06T00:00:00.000Z,9020,5307921,57.08,16786,4900915,52.7,0,0,0,0,0,0,54.21,0,45.79
2021-04-07T00:00:00.000Z,8919,5316840,57.17,15302,4916217,52.87,0,0,0,0,0,0,54.36,0,45.64
2021-04-08T00:00:00.000Z,9416,5326256,57.28,17002,4933219,53.05,0,0,0,0,0,0,54.52,0,45.48
2021-04-09T00:00:00.000Z,3602,5329858,57.31,6242,4939461,53.12,0,0,0,0,0,0,54.58,0,45.42
2021-04-10T00:00:00.000Z,1630,5331488,57.33,3519,4942980,53.15,0,0,0,0,0,0,54.61,0,45.39
2021-04-11T00:00:00.000Z,9032,5340520,57.43,14244,4957224,53.31,0,0,0,0,0,0,54.78,0,45.22
2021-04-12T00:00:00.000Z,8929,5349449,57.53,13224,4970448,53.45,0,0,0,0,0,0,54.95,0,45.05
2021-04-13T00:00:00.000Z,5833,5355282,57.59,4953,4975401,53.5,0,0,0,0,0,0,55.08,0,44.92
2021-04-14T00:00:00.000Z,3642,5358924,57.63,5299,4980700,53.56,0,0,0,0,0,0,55.18,0,44.82
2021-04-15T00:00:00.000Z,688,5359612,57.63,572,4981272,53.57,0,0,0,0,0,0,55.27,0,44.73
2021-04-16T00:00:00.000Z,3408,5363020,57.67,6641,4987913,53.64,0,0,0,0,0,0,55.33,0,44.67
2021-04-17T00:00:00.000Z,818,5363838,57.68,1970,4989883,53.66,0,0,0,0,0,0,55.35,0,44.65
2021-04-18T00:00:00.000Z,7091,5370929,57.76,7432,4997315,53.74,0,0,0,0,0,0,55.47,0,44.53
2021-04-19T00:00:00.000Z,6393,5377322,57.83,7123,5004438,53.82,0,0,0,0,0,0,55.58,0,44.42
2021-04-20T00:00:00.000Z,6272,5383594,57.89,6881,5011319,53.89,0,0,0,0,0,0,55.65,0,44.35
2021-04-21T00:00:00.000Z,6370,5389964,57.96,7099,5018418,53.97,0,0,0,0,0,0,55.71,0,44.29
2021-04-22T00:00:00.000Z,5941,5395905,58.02,7679,5026097,54.05,0,0,0,0,0,0,55.75,0,44.25
2021-04-23T00:00:00.000Z,2756,5398661,58.05,3382,5029479,54.08,0,0,0,0,0,0,55.8,0,44.2
2021-04-24T00:00:00.000Z,766,5399427,58.06,1286,5030765,54.1,0,0,0,0,0,0,55.82,0,44.18
2021-04-25T00:00:00.000Z,4827,5404254,58.11,6917,5037682,54.17,0,0,0,0,0,0,55.89,0,44.11
2021-04-26T00:00:00.000Z,5472,5409726,58.17,7885,5045567,54.26,0,0,0,0,0,0,55.96,0,44.04
2021-04-27T00:00:00.000Z,4500,5414226,58.22,6618,5052185,54.33,0,0,0,0,0,0,56.03,0,43.97
2021-04-28T00:00:00.000Z,4488,5418714,58.27,7319,5059504,54.41,0,0,0,0,0,0,56.09,0,43.91
2021-04-29T00:00:00.000Z,4369,5423083,58.32,7284,5066788,54.49,0,0,0,0,0,0,56.16,0,43.84
2021-04-30T00:00:00.000Z,1917,5425000,58.34,3194,5069982,54.52,0,0,0,0,0,0,56.19,0,43.81
2021-05-01T00:00:00.000Z,456,5425456,58.34,891,5070873,54.53,0,0,0,0,0,0,56.2,0,43.8
2021-05-02T00:00:00.000Z,3224,5428680,58.38,6085,5076958,54.6,0,0,0,0,0,0,56.26,0,43.74
2021-05-03T00:00:00.000Z,3533,5432213,58.42,5827,5082785,54.66,0,0,0,0,0,0,56.32,0,43.68
2021-05-04T00:00:00.000Z,3582,5435795,58.45,4723,5087508,54.71,0,0,0,0,0,0,56.38,0,43.62
2021-05-05T00:00:00.000Z,3284,5439079,58.49,4086,5091594,54.75,0,0,0,0,0,0,56.44,0,43.56
2021-05-06T00:00:00.000Z,3636,5442715,58.53,3138,5094732,54.79,0,0,0,0,0,0,56.5,0,43.5
2021-05-07T00:00:00.000Z,1833,5444548,58.55,2499,5097231,54.81,0,0,0,0,0,0,56.52,0,43.48
2021-05-08T00:00:00.000Z,235,5444783,58.55,505,5097736,54.82,0,0,0,0,0,0,56.53,0,43.47
2021-05-09T00:00:00.000Z,2846,5447629,58.58,4743,5102479,54.87,0,0,0,0,0,0,56.58,0,43.42
2021-05-10T00:00:00.000Z,2891,5450520,58.61,4702,5107181,54.92,0,0,0,0,0,0,56.63,0,43.37
2021-05-11T00:00:00.000Z,2619,5453139,58.64,3873,5111054,54.96,0,0,0,0,0,0,56.67,0,43.33
2021-05-12T00:00:00.000Z,2022,5455161,58.66,3333,5114387,55,0,0,0,0,0,0,56.7,0,43.3
2021-05-13T00:00:00.000Z,2037,5457198,58.68,3675,5118062,55.04,0,0,0,0,0,0,56.73,0,43.27
2021-05-14T00:00:00.000Z,971,5458169,58.69,1488,5119550,55.05,0,0,0,0,0,0,56.75,0,43.25
2021-05-15T00:00:00.000Z,250,5458419,58.7,255,5119805,55.06,0,0,0,0,0,0,56.75,0,43.25
2021-05-16T00:00:00.000Z,526,5458945,58.7,1201,5121006,55.07,0,0,0,0,0,0,56.78,0,43.22
2021-05-17T00:00:00.000Z,295,5459240,58.71,841,5121847,55.08,0,0,0,0,0,0,56.81,0,43.19
2021-05-18T00:00:00.000Z,1956,5461196,58.73,4933,5126780,55.13,0,0,0,0,0,0,56.84,0,43.16
2021-05-19T00:00:00.000Z,2221,5463417,58.75,5033,5131813,55.18,0,0,0,0,0,0,56.87,0,43.13
2021-05-20T00:00:00.000Z,2307,5465724,58.78,3875,5135688,55.23,0,0,0,0,0,0,56.9,0,43.1
2021-05-21T00:00:00.000Z,1179,5466903,58.79,1402,5137090,55.24,0,0,0,0,0,0,56.92,0,43.08
2021-05-22T00:00:00.000Z,205,5467108,58.79,395,5137485,55.25,0,0,0,0,0,0,56.92,0,43.08
2021-05-23T00:00:00.000Z,2269,5469377,58.81,3214,5140699,55.28,0,0,0,0,0,0,56.94,0,43.06
2021-05-24T00:00:00.000Z,2127,5471504,58.84,3595,5144294,55.32,0,0,0,0,0,0,56.96,0,43.04
2021-05-25T00:00:00.000Z,1815,5473319,58.86,2583,5146877,55.35,0,0,0,0,0,0,56.99,0,43.01
2021-05-26T00:00:00.000Z,1400,5474719,58.87,2499,5149376,55.37,0,0,0,0,0,0,57.03,0,42.97
2021-05-27T00:00:00.000Z,1846,5476565,58.89,3180,5152556,55.41,0,0,0,0,0,0,57.06,0,42.94
2021-05-28T00:00:00.000Z,775,5477340,58.9,1401,5153957,55.42,0,0,0,0,0,0,57.07,0,42.93
2021-05-29T00:00:00.000Z,187,5477527,58.9,223,5154180,55.43,0,0,0,0,0,0,57.07,0,42.93
2021-05-30T00:00:00.000Z,1639,5479166,58.92,1933,5156113,55.45,0,0,0,0,0,0,57.1,0,42.9
2021-05-31T00:00:00.000Z,1730,5480896,58.94,2088,5158201,55.47,0,0,0,0,0,0,57.13,0,42.87
2021-06-01T00:00:00.000Z,1370,5482266,58.95,1816,5160017,55.49,0,0,0,0,0,0,57.47,0,42.53
2021-06-02T00:00:00.000Z,1506,5483772,58.97,1603,5161620,55.51,0,0,0,0,0,0,57.25,0,42.75
2021-06-03T00:00:00.000Z,1676,5485448,58.99,1486,5163106,55.52,0,0,0,0,0,0,57.27,0,42.73
2021-06-04T00:00:00.000Z,1089,5486537,59,775,5163881,55.53,0,0,0,0,0,0,57.28,0,42.72
2021-06-05T00:00:00.000Z,180,5486717,59,158,5164039,55.53,0,0,0,0,0,0,57.29,0,42.71
2021-06-06T00:00:00.000Z,4286,5491003,59.05,1001,5165040,55.54,0,0,0,0,0,0,57.31,0,42.69
2021-06-07T00:00:00.000Z,4430,5495433,59.1,807,5165847,55.55,0,0,0,0,0,0,57.34,0,42.66
2021-06-08T00:00:00.000Z,3732,5499165,59.14,1167,5167014,55.56,0,0,0,0,0,0,57.36,0,42.64
2021-06-09T00:00:00.000Z,3609,5502774,59.17,1320,5168334,55.58,0,0,0,0,0,0,57.4,0,42.6
2021-06-10T00:00:00.000Z,3351,5506125,59.21,1292,5169626,55.59,0,0,0,0,0,0,57.42,0,42.58
2021-06-11T00:00:00.000Z,1390,5507515,59.23,580,5170206,55.6,0,0,0,0,0,0,57.43,0,42.57
2021-06-12T00:00:00.000Z,213,5507728,59.23,169,5170375,55.6,0,0,0,0,0,0,57.43,0,42.57
2021-06-13T00:00:00.000Z,3100,5510828,59.26,1255,5171630,55.61,0,0,0,0,0,0,57.45,0,42.55
2021-06-14T00:00:00.000Z,3047,5513875,59.29,1523,5173153,55.63,0,0,0,0,0,0,57.46,0,42.54
2021-06-15T00:00:00.000Z,3135,5517010,59.33,1368,5174521,55.64,0,0,0,0,0,0,57.48,0,42.52
2021-06-16T00:00:00.000Z,2724,5519734,59.36,993,5175514,55.65,0,0,0,0,0,0,57.49,0,42.51
2021-06-17T00:00:00.000Z,2720,5522454,59.39,1192,5176706,55.67,0,0,0,0,0,0,57.51,0,42.49
2021-06-18T00:00:00.000Z,1263,5523717,59.4,498,5177204,55.67,0,0,0,0,0,0,57.52,0,42.48
2021-06-19T00:00:00.000Z,235,5523952,59.4,139,5177343,55.67,0,0,0,0,0,0,57.52,0,42.48
2021-06-20T00:00:00.000Z,3312,5527264,59.44,1330,5178673,55.69,0,0,0,0,0,0,57.54,0,42.46
2021-06-21T00:00:00.000Z,5232,5532496,59.49,1210,5179883,55.7,0,0,0,0,0,0,57.56,0,42.44
2021-06-22T00:00:00.000Z,6919,5539415,59.57,1093,5180976,55.71,0,0,0,0,0,0,57.58,0,42.42
2021-06-23T00:00:00.000Z,10743,5550158,59.68,1289,5182265,55.73,0,0,0,0,0,0,57.6,0,42.4
2021-06-24T00:00:00.000Z,12037,5562195,59.81,1460,5183725,55.74,0,0,0,0,0,0,57.62,0,42.38
2021-06-25T00:00:00.000Z,7103,5569298,59.89,939,5184664,55.75,0,0,0,0,0,0,57.62,0,42.38
2021-06-26T00:00:00.000Z,2265,5571563,59.91,196,5184860,55.76,0,0,0,0,0,0,57.63,0,42.37
2021-06-27T00:00:00.000Z,13628,5585191,60.06,3434,5188294,55.79,0,0,0,0,0,0,57.65,0,42.35
2021-06-28T00:00:00.000Z,14512,5599703,60.22,3672,5191966,55.83,0,0,0,0,0,0,57.68,0,42.32
2021-06-29T00:00:00.000Z,16704,5616407,60.4,3735,5195701,55.87,0,0,0,0,0,0,57.69,0,42.31
2021-06-30T00:00:00.000Z,16477,5632884,60.57,3392,5199093,55.91,0,0,0,0,0,0,57.72,0,42.28
2021-07-01T00:00:00.000Z,16819,5649703,60.75,3368,5202461,55.94,119,119,0,0,0,0,57.78,0,42.22
2021-07-02T00:00:00.000Z,9825,5659528,60.86,1594,5204055,55.96,7,126,0,0,0,0,57.79,0,42.21
2021-07-03T00:00:00.000Z,2671,5662199,60.89,296,5204351,55.96,1,127,0,0,0,0,57.79,0,42.21
2021-07-04T00:00:00.000Z,17730,5679929,61.08,3155,5207506,56,1,128,0,0,0,0,57.85,0,42.15
2021-07-05T00:00:00.000Z,17844,5697773,61.27,3040,5210546,56.03,7,135,0,0,0,0,57.91,0,42.09
2021-07-06T00:00:00.000Z,17835,5715608,61.46,3404,5213950,56.07,11,146,0,0,0,0,57.99,0,42.01
2021-07-07T00:00:00.000Z,15521,5731129,61.63,2694,5216644,56.1,12,158,0,0,0,0,58.05,0,41.95
2021-07-08T00:00:00.000Z,16577,5747706,61.81,2871,5219515,56.13,17,175,0,0,0,0,58.12,0,41.88
2021-07-09T00:00:00.000Z,11119,5758825,61.93,1530,5221045,56.14,4,179,0,0,0,0,58.15,0,41.85
2021-07-10T00:00:00.000Z,4980,5763805,61.98,384,5221429,56.15,6,185,0,0,0,0,58.15,0,41.85
2021-07-11T00:00:00.000Z,1453,5765258,62,2846,5224275,56.18,8,193,0,0,0,0,58.22,0,41.78
2021-07-12T00:00:00.000Z,2417,5767675,62.02,3677,5227952,56.22,56,249,0,0,0,0,58.29,0,41.71
2021-07-13T00:00:00.000Z,2954,5770629,62.05,5456,5233408,56.28,124,373,0,0,0,0,58.36,0,41.64
2021-07-14T00:00:00.000Z,2738,5773367,62.08,7523,5240931,56.36,441,814,0.01,0,0,0,58.42,0,41.58
2021-07-15T00:00:00.000Z,2995,5776362,62.12,9284,5250215,56.46,374,1188,0.01,0,0,0,58.5,0,41.5
2021-07-16T00:00:00.000Z,1279,5777641,62.13,5889,5256104,56.52,65,1253,0.01,0,0,0,58.54,0,41.46
2021-07-17T00:00:00.000Z,366,5778007,62.13,1387,5257491,56.54,7,1260,0.01,0,0,0,58.55,0,41.44
2021-07-18T00:00:00.000Z,2069,5780076,62.16,9765,5267256,56.64,235,1495,0.02,0,0,0,58.6,0,41.4
2021-07-19T00:00:00.000Z,3206,5783282,62.19,11340,5278596,56.76,461,1956,0.02,0,0,0,58.65,0,41.35
2021-07-20T00:00:00.000Z,2679,5785961,62.22,11904,5290500,56.89,373,2329,0.03,0,0,0,58.72,0,41.28
2021-07-21T00:00:00.000Z,2392,5788353,62.25,11872,5302372,57.02,325,2654,0.03,0,0,0,58.81,0,41.19
2021-07-22T00:00:00.000Z,2870,5791223,62.28,13262,5315634,57.16,391,3045,0.03,0,0,0,58.93,0,41.07
2021-07-23T00:00:00.000Z,2025,5793248,62.3,8231,5323865,57.25,106,3151,0.03,0,0,0,58.99,0,41.01
2021-07-24T00:00:00.000Z,639,5793887,62.3,1477,5325342,57.27,7,3158,0.03,0,0,0,58.99,0,41
2021-07-25T00:00:00.000Z,4413,5798300,62.35,15485,5340827,57.43,223,3381,0.04,0,0,0,59.1,0,40.89
2021-07-26T00:00:00.000Z,5161,5803461,62.41,13522,5354349,57.58,323,3704,0.04,0,0,0,59.24,0,40.75
2021-07-27T00:00:00.000Z,5485,5808946,62.47,13565,5367914,57.72,413,4117,0.04,0,0,0,59.37,0.01,40.62
2021-07-28T00:00:00.000Z,3982,5812928,62.51,12337,5380251,57.86,472,4589,0.05,0,0,0,59.5,0.01,40.49
2021-07-29T00:00:00.000Z,4656,5817584,62.56,14187,5394438,58.01,530,5119,0.06,0,0,0,59.65,0.01,40.33
2021-07-30T00:00:00.000Z,2644,5820228,62.59,10845,5405283,58.13,4121,9240,0.1,0,0,0,59.74,0.02,40.25
2021-07-31T00:00:00.000Z,1402,5821630,62.6,3546,5408829,58.16,6159,15399,0.17,0,0,0,59.75,0.02,40.23
2021-08-01T00:00:00.000Z,3072,5824702,62.64,3361,5412190,58.2,31046,46445,0.5,0,0,0,59.91,0.02,40.06
2021-08-02T00:00:00.000Z,3125,5827827,62.67,3165,5415355,58.23,58508,104953,1.13,0,0,0,60.06,0.03,39.91
2021-08-03T00:00:00.000Z,3380,5831207,62.71,3318,5418673,58.27,78951,183904,1.98,0,0,0,60.21,0.03,39.76
2021-08-04T00:00:00.000Z,3519,5834726,62.74,3246,5421919,58.3,80762,264666,2.85,0,0,0,60.34,0.03,39.63
2021-08-05T00:00:00.000Z,4504,5839230,62.79,3565,5425484,58.34,88440,353106,3.8,0,0,0,60.49,0.04,39.47
2021-08-06T00:00:00.000Z,2430,5841660,62.82,1844,5427328,58.36,44741,397847,4.28,0,0,0,60.6,0.04,39.36
2021-08-07T00:00:00.000Z,1026,5842686,62.83,686,5428014,58.37,27352,425199,4.57,0,0,0,60.63,0.04,39.32
2021-08-08T00:00:00.000Z,4987,5847673,62.88,3075,5431089,58.4,80084,505283,5.43,0,0,0,60.68,0.04,39.28
2021-08-09T00:00:00.000Z,5336,5853009,62.94,3051,5434140,58.44,76487,581770,6.26,0,0,0,60.72,0.04,39.24
2021-08-10T00:00:00.000Z,5541,5858550,63,3198,5437338,58.47,75425,657195,7.07,0,0,0,60.75,0.04,39.2
2021-08-11T00:00:00.000Z,5690,5864240,63.06,2937,5440275,58.5,62634,719829,7.74,0,0,0,60.79,0.04,39.17
2021-08-12T00:00:00.000Z,7023,5871263,63.14,3283,5443558,58.54,59459,779288,8.38,0,0,0,60.83,0.04,39.12
2021-08-13T00:00:00.000Z,3809,5875072,63.18,2059,5445617,58.56,43869,823157,8.85,0,0,0,60.84,0.05,39.11
2021-08-14T00:00:00.000Z,2247,5877319,63.2,849,5446466,58.57,44484,867641,9.33,0,0,0,60.85,0.05,39.1
2021-08-15T00:00:00.000Z,7139,5884458,63.28,4528,5450994,58.62,97977,965618,10.38,0,0,0,60.89,0.05,39.06
2021-08-16T00:00:00.000Z,6984,5891442,63.35,4738,5455732,58.67,89513,1055131,11.35,0,0,0,60.92,0.04,39.03
2021-08-17T00:00:00.000Z,7570,5899012,63.44,5129,5460861,58.72,83315,1138446,12.24,0,0,0,60.96,0.04,39
2021-08-18T00:00:00.000Z,8632,5907644,63.53,4599,5465460,58.77,69258,1207704,12.99,0,0,0,60.99,0.04,38.96
2021-08-19T00:00:00.000Z,10067,5917711,63.64,5210,5470670,58.83,65971,1273675,13.7,0,0,0,61.03,0.04,38.92
2021-08-20T00:00:00.000Z,4762,5922473,63.69,2821,5473491,58.86,60446,1334121,14.35,0,0,0,61.05,0.05,38.9
2021-08-21T00:00:00.000Z,3490,5925963,63.72,1574,5475065,58.88,50723,1384844,14.89,0,0,0,61.06,0.05,38.89
2021-08-22T00:00:00.000Z,9823,5935786,63.83,4800,5479865,58.93,105097,1489941,16.02,0,0,0,61.12,0.04,38.84
2021-08-23T00:00:00.000Z,10930,5946716,63.95,4441,5484306,58.98,94009,1583950,17.03,0,0,0,61.17,0.04,38.79
2021-08-24T00:00:00.000Z,11725,5958441,64.07,4696,5489002,59.03,98530,1682480,18.09,0,0,0,61.23,0.04,38.73
2021-08-25T00:00:00.000Z,9614,5968055,64.18,4477,5493479,59.07,99517,1781997,19.16,0,0,0,61.29,0.04,38.67
2021-08-26T00:00:00.000Z,10110,5978165,64.29,5048,5498527,59.13,101199,1883196,20.25,0,0,0,61.36,0.03,38.61
2021-08-27T00:00:00.000Z,4320,5982485,64.33,2778,5501305,59.16,56687,1939883,20.86,0,0,0,61.35,0.04,38.61
2021-08-28T00:00:00.000Z,3696,5986181,64.37,1494,5502799,59.17,33535,1973418,21.22,0,0,0,61.4,0.04,38.57
2021-08-29T00:00:00.000Z,10328,5996509,64.48,5930,5508729,59.24,79522,2052940,22.08,0,0,0,61.46,0.03,38.5
2021-08-30T00:00:00.000Z,12336,6008845,64.62,7011,5515740,59.31,115981,2168921,23.32,0,0,0,61.53,0.03,38.44
2021-08-31T00:00:00.000Z,12081,6020926,64.75,6519,5522259,59.38,114852,2283773,24.56,0,0,0,61.6,0.03,38.37
2021-09-01T00:00:00.000Z,9037,6029963,64.84,6026,5528285,59.45,112470,2396243,25.77,0,0,0,61.43,0.03,38.54
2021-09-02T00:00:00.000Z,8783,6038746,64.94,7176,5535461,59.53,111522,2507765,26.97,0,0,0,61.49,0.03,38.48
2021-09-03T00:00:00.000Z,3745,6042491,64.98,4108,5539569,59.57,58878,2566643,27.6,0,0,0,61.56,0.03,38.42
2021-09-04T00:00:00.000Z,2692,6045183,65.01,2017,5541586,59.59,29943,2596586,27.92,0,0,0,61.59,0.03,38.38
2021-09-05T00:00:00.000Z,6991,6052174,65.08,6456,5548042,59.66,73317,2669903,28.71,0,0,0,61.68,0.03,38.29
2021-09-06T00:00:00.000Z,2826,6055000,65.11,2705,5550747,59.69,22793,2692696,28.96,0,0,0,61.77,0.03,38.2
2021-09-07T00:00:00.000Z,1197,6056197,65.13,875,5551622,59.7,5396,2698092,29.01,0,0,0,61.85,0.03,38.12
2021-09-08T00:00:00.000Z,1376,6057573,65.14,1190,5552812,59.71,6619,2704711,29.09,0,0,0,61.93,0.03,38.05
2021-09-09T00:00:00.000Z,7088,6064661,65.22,12563,5565375,59.85,73832,2778543,29.88,0,0,0,62.02,0.03,37.95
2021-09-10T00:00:00.000Z,3254,6067915,65.25,5007,5570382,59.9,37929,2816472,30.29,0,0,0,62.06,0.03,37.91
2021-09-11T00:00:00.000Z,2105,6070020,65.27,2500,5572882,59.93,14813,2831285,30.45,0,0,0,62.08,0.03,37.89
2021-09-12T00:00:00.000Z,6112,6076132,65.34,8585,5581467,60.02,54120,2885405,31.03,0,0,0,62.16,0.03,37.81
2021-09-13T00:00:00.000Z,5608,6081740,65.4,8254,5589721,60.11,47972,2933377,31.54,0,0,0,62.15,0.03,37.82
2021-09-14T00:00:00.000Z,4957,6086697,65.45,7414,5597135,60.19,48846,2982223,32.07,0,0,0,62.2,0.03,37.77
2021-09-15T00:00:00.000Z,1743,6088440,65.47,2712,5599847,60.22,16683,2998906,32.25,0,0,0,62.25,0.03,37.72
2021-09-16T00:00:00.000Z,337,6088777,65.48,544,5600391,60.22,1740,3000646,32.27,0,0,0,62.37,0.03,37.6
2021-09-17T00:00:00.000Z,3675,6092452,65.52,7013,5607404,60.3,42895,3043541,32.73,0,0,0,62.42,0.03,37.54
2021-09-18T00:00:00.000Z,2255,6094707,65.54,2941,5610345,60.33,12782,3056323,32.87,0,0,0,62.45,0.03,37.52
2021-09-19T00:00:00.000Z,5941,6100648,65.6,10708,5621053,60.45,44327,3100650,33.34,0,0,0,62.55,0.03,37.42
2021-09-20T00:00:00.000Z,3241,6103889,65.64,4639,5625692,60.5,16702,3117352,33.52,0,0,0,62.63,0.03,37.34
2021-09-21T00:00:00.000Z,1334,6105223,65.65,2053,5627745,60.52,3474,3120826,33.56,0,0,0,62.69,0.03,37.28
2021-09-22T00:00:00.000Z,4256,6109479,65.7,7244,5634989,60.6,25064,3145890,33.83,0,0,0,62.72,0.03,37.25
2021-09-23T00:00:00.000Z,4387,6113866,65.75,5903,5640892,60.66,27829,3173719,34.13,0,0,0,62.75,0.03,37.22
2021-09-24T00:00:00.000Z,3198,6117064,65.78,4182,5645074,60.7,27716,3201435,34.43,0,0,0,62.82,0.03,37.15
2021-09-25T00:00:00.000Z,2073,6119137,65.8,2255,5647329,60.73,10440,3211875,34.54,0,0,0,62.85,0.03,37.12
2021-09-26T00:00:00.000Z,5604,6124741,65.86,5968,5653297,60.79,36262,3248137,34.93,0,0,0,62.96,0.03,37
2021-09-27T00:00:00.000Z,4692,6129433,65.91,4460,5657757,60.84,30448,3278585,35.26,0,0,0,63.02,0.03,36.94
2021-09-28T00:00:00.000Z,1465,6130898,65.93,1178,5658935,60.85,6248,3284833,35.32,0,0,0,63.06,0.04,36.91
2021-09-29T00:00:00.000Z,9619,6140517,66.03,8342,5667277,60.94,60321,3345154,35.97,0,0,0,63.13,0.03,36.84
2021-09-30T00:00:00.000Z,10969,6151486,66.15,8567,5675844,61.04,79696,3424850,36.83,0,0,0,63.18,0.03,36.79
2021-10-01T00:00:00.000Z,5117,6156603,66.21,3870,5679714,61.08,46537,3471387,37.33,0,0,0,63.23,0.03,36.73
2021-10-02T00:00:00.000Z,2859,6159462,66.24,2123,5681837,61.1,22428,3493815,37.57,0,0,0,63.26,0.03,36.71
2021-10-03T00:00:00.000Z,11666,6171128,66.36,7271,5689108,61.18,70721,3564536,38.33,0,0,0,63.35,0.03,36.62
2021-10-04T00:00:00.000Z,10316,6181444,66.47,6753,5695861,61.25,51900,3616436,38.89,0,0,0,63.4,0.03,36.57
2021-10-05T00:00:00.000Z,8455,6189899,66.56,5303,5701164,61.31,40471,3656907,39.32,0,0,0,63.41,0.03,36.55
2021-10-06T00:00:00.000Z,7541,6197440,66.64,4173,5705337,61.35,34131,3691038,39.69,0,0,0,63.52,0.03,36.45
2021-10-07T00:00:00.000Z,6889,6204329,66.72,4004,5709341,61.4,34054,3725092,40.06,0,0,0,63.63,0.03,36.34
2021-10-08T00:00:00.000Z,3088,6207417,66.75,2632,5711973,61.42,19238,3744330,40.26,0,0,0,63.68,0.03,36.29
2021-10-09T00:00:00.000Z,1335,6208752,66.77,1440,5713413,61.44,7440,3751770,40.34,0,0,0,63.71,0.03,36.26
2021-10-10T00:00:00.000Z,4675,6213427,66.82,3743,5717156,61.48,21512,3773282,40.58,0,0,0,63.82,0.04,36.14
2021-10-11T00:00:00.000Z,4293,6217720,66.86,2941,5720097,61.51,17257,3790539,40.76,0,0,0,63.91,0.04,36.05
2021-10-12T00:00:00.000Z,3971,6221691,66.91,3001,5723098,61.54,15354,3805893,40.93,0,0,0,63.99,0.05,35.96
2021-10-13T00:00:00.000Z,3484,6225175,66.94,2446,5725544,61.57,13579,3819472,41.07,0,0,0,64.09,0.05,35.86
2021-10-14T00:00:00.000Z,3865,6229040,66.98,2681,5728225,61.6,16562,3836034,41.25,0,0,0,64.19,0.06,35.75
2021-10-15T00:00:00.000Z,1696,6230736,67,1678,5729903,61.62,9005,3845039,41.35,0,0,0,64.23,0.07,35.7
2021-10-16T00:00:00.000Z,725,6231461,67.01,951,5730854,61.63,4034,3849073,41.39,0,0,0,64.25,0.08,35.67
2021-10-17T00:00:00.000Z,3087,6234548,67.04,2521,5733375,61.65,12792,3861865,41.53,0,0,0,64.36,0.09,35.56
2021-10-18T00:00:00.000Z,2454,6237002,67.07,1682,5735057,61.67,10065,3871930,41.64,0,0,0,64.43,0.1,35.47
2021-10-19T00:00:00.000Z,2392,6239394,67.1,1277,5736334,61.69,9296,3881226,41.74,0,0,0,64.49,0.1,35.4
2021-10-20T00:00:00.000Z,2430,6241824,67.12,2302,5738636,61.71,10089,3891315,41.85,0,0,0,64.14,0.52,35.34
2021-10-21T00:00:00.000Z,3032,6244856,67.15,3088,5741724,61.74,12157,3903472,41.98,0,0,0,54.23,10.41,35.36
2021-10-22T00:00:00.000Z,1274,6246130,67.17,1428,5743152,61.76,5827,3909299,42.04,0,0,0,54.36,10.26,35.38
2021-10-23T00:00:00.000Z,570,6246700,67.17,1262,5744414,61.77,2559,3911858,42.07,0,0,0,54.42,10.19,35.39
2021-10-24T00:00:00.000Z,2511,6249211,67.2,2652,5747066,61.8,9852,3921710,42.17,0,0,0,54.22,10.43,35.35
2021-10-25T00:00:00.000Z,2632,6251843,67.23,2740,5749806,61.83,8502,3930212,42.26,0,0,0,54.59,10.22,35.19
2021-10-26T00:00:00.000Z,2375,6254218,67.25,2044,5751850,61.85,8515,3938727,42.36,0,0,0,54.64,10.26,35.1
2021-10-27T00:00:00.000Z,2285,6256503,67.28,2560,5754410,61.88,7950,3946677,42.44,0,0,0,54.58,10.37,35.06
2021-10-28T00:00:00.000Z,2496,6258999,67.31,2771,5757181,61.91,8660,3955337,42.53,0,0,0,54.69,10.76,34.55
2021-10-29T00:00:00.000Z,897,6259896,67.32,1143,5758324,61.92,4129,3959466,42.58,0,0,0,54.73,10.75,34.52
2021-10-30T00:00:00.000Z,363,6260259,67.32,528,5758852,61.93,1709,3961175,42.6,0,0,0,54.68,10.81,34.52
2021-10-31T00:00:00.000Z,2258,6262517,67.34,2490,5761342,61.95,8250,3969425,42.69,0,0,0,54.83,10.7,34.47
2021-11-01T00:00:00.000Z,1732,6264249,67.36,2088,5763430,61.98,6475,3975900,42.75,0,0,0,54.95,10.63,34.42
2021-11-02T00:00:00.000Z,2020,6266269,67.38,2041,5765471,62,6283,3982183,42.82,0,0,0,54.89,10.69,34.42
2021-11-03T00:00:00.000Z,1757,6268026,67.4,1887,5767358,62.02,5550,3987733,42.88,0,0,0,54.86,10.75,34.39
2021-11-04T00:00:00.000Z,2104,6270130,67.43,2794,5770152,62.05,7125,3994858,42.96,0,0,0,54.85,10.81,34.33
2021-11-05T00:00:00.000Z,782,6270912,67.43,898,5771050,62.06,3475,3998333,43,0,0,0,54.85,10.83,34.32
2021-11-06T00:00:00.000Z,344,6271256,67.44,384,5771434,62.06,1370,3999703,43.01,0,0,0,54.82,10.86,34.32
2021-11-07T00:00:00.000Z,1579,6272835,67.45,1768,5773202,62.08,6129,4005832,43.08,0,0,0,54.92,10.8,34.28
2021-11-08T00:00:00.000Z,1515,6274350,67.47,1598,5774800,62.1,5405,4011237,43.13,0,0,0,55.01,10.75,34.24
2021-11-09T00:00:00.000Z,1427,6275777,67.49,1602,5776402,62.12,5327,4016564,43.19,0,0,0,55.05,10.74,34.21
2021-11-10T00:00:00.000Z,1423,6277200,67.5,1651,5778053,62.13,4775,4021339,43.24,0,0,0,55.08,10.73,34.19
2021-11-11T00:00:00.000Z,1624,6278824,67.52,1940,5779993,62.16,5706,4027045,43.3,0,0,0,55.15,10.69,34.15
2021-11-12T00:00:00.000Z,632,6279456,67.53,820,5780813,62.16,2920,4029965,43.34,0,0,0,55.17,10.69,34.14
2021-11-13T00:00:00.000Z,252,6279708,67.53,284,5781097,62.17,1125,4031090,43.35,0,0,0,55.14,10.72,34.14
2021-11-14T00:00:00.000Z,1538,6281246,67.55,1635,5782732,62.18,5106,4036196,43.4,0,0,0,55.21,10.68,34.11
2021-11-15T00:00:00.000Z,1272,6282518,67.56,1616,5784348,62.2,4766,4040962,43.45,0,0,0,55.28,10.63,34.09
2021-11-16T00:00:00.000Z,1271,6283789,67.57,1406,5785754,62.22,4339,4045301,43.5,0,0,0,55.32,10.62,34.07
2021-11-17T00:00:00.000Z,1201,6284990,67.59,1558,5787312,62.23,3905,4049206,43.54,0,0,0,55.35,10.6,34.05
2021-11-18T00:00:00.000Z,1358,6286348,67.6,1684,5788996,62.25,5004,4054210,43.6,0,0,0,55.41,10.58,34.02
2021-11-19T00:00:00.000Z,586,6286934,67.61,757,5789753,62.26,2451,4056661,43.62,0,0,0,55.42,10.57,34.01
2021-11-20T00:00:00.000Z,236,6287170,67.61,254,5790007,62.26,925,4057586,43.63,0,0,0,55.41,10.58,34
2021-11-21T00:00:00.000Z,1410,6288580,67.62,1536,5791543,62.28,4874,4062460,43.69,0,0,0,55.47,10.54,33.98
2021-11-22T00:00:00.000Z,1680,6290260,67.64,1516,5793059,62.3,4231,4066691,43.73,0,0,0,55.54,10.5,33.96
2021-11-23T00:00:00.000Z,8614,6298874,67.73,1675,5794734,62.31,3999,4070690,43.77,0,0,0,55.57,10.48,33.95
2021-11-24T00:00:00.000Z,9348,6308222,67.84,1311,5796045,62.33,3916,4074606,43.82,0,0,0,55.6,10.44,33.95
2021-11-25T00:00:00.000Z,9810,6318032,67.94,1598,5797643,62.34,4832,4079438,43.87,0,0,0,55.64,10.43,33.93
2021-11-26T00:00:00.000Z,5611,6323643,68,743,5798386,62.35,2797,4082235,43.9,0,0,0,55.63,10.45,33.92
2021-11-27T00:00:00.000Z,4777,6328420,68.05,321,5798707,62.36,1160,4083395,43.91,0,0,0,55.62,10.46,33.92
2021-11-28T00:00:00.000Z,10148,6338568,68.16,1476,5800183,62.37,4896,4088291,43.96,0,0,0,55.67,10.43,33.9
2021-11-29T00:00:00.000Z,9039,6347607,68.26,1129,5801312,62.38,4365,4092656,44.01,0,0,0,55.73,10.39,33.88
2021-11-30T00:00:00.000Z,10041,6357648,68.37,1029,5802341,62.4,4081,4096737,44.05,0,0,0,55.77,10.37,33.86
2021-12-01T00:00:00.000Z,8624,6366272,68.46,1092,5803433,62.41,4435,4101172,44.1,5,5,0,55.79,10.36,33.84
2021-12-02T00:00:00.000Z,9168,6375440,68.56,1447,5804880,62.42,5116,4106288,44.16,6,11,0,55.84,10.34,33.82
2021-12-03T00:00:00.000Z,6331,6381771,68.63,670,5805550,62.43,2859,4109147,44.19,1,12,0,55.86,10.33,33.81
2021-12-04T00:00:00.000Z,2508,6384279,68.65,232,5805782,62.43,914,4110061,44.2,3,15,0,55.85,10.34,33.81
2021-12-05T00:00:00.000Z,8334,6392613,68.74,1250,5807032,62.45,4679,4114740,44.25,1,16,0,55.9,10.31,33.79
2021-12-06T00:00:00.000Z,6722,6399335,68.82,1193,5808225,62.46,4346,4119086,44.29,4,20,0,55.95,10.27,33.78
2021-12-07T00:00:00.000Z,5554,6404889,68.88,1496,5809721,62.47,3956,4123042,44.34,9,29,0,55.99,10.25,33.76
2021-12-08T00:00:00.000Z,4929,6409818,68.93,1197,5810918,62.49,3874,4126916,44.38,10,39,0,56.03,10.22,33.75
2021-12-09T00:00:00.000Z,6237,6416055,69,1232,5812150,62.5,4499,4131415,44.43,8,47,0,56.08,10.19,33.73
2021-12-10T00:00:00.000Z,3006,6419061,69.03,696,5812846,62.51,2675,4134090,44.46,4,51,0,56.1,10.18,33.72
2021-12-11T00:00:00.000Z,1491,6420552,69.04,251,5813097,62.51,1011,4135101,44.47,0,51,0,56.1,10.18,33.71
2021-12-12T00:00:00.000Z,7272,6427824,69.12,1441,5814538,62.53,5244,4140345,44.52,3,54,0,56.16,10.15,33.69
2021-12-13T00:00:00.000Z,6176,6434000,69.19,1371,5815909,62.54,4344,4144689,44.57,4,58,0,56.21,10.11,33.67
2021-12-14T00:00:00.000Z,7315,6441315,69.27,6100,5822009,62.61,4928,4149617,44.62,11,69,0,56.27,10.09,33.65
2021-12-15T00:00:00.000Z,7201,6448516,69.34,7402,5829411,62.69,5438,4155055,44.68,7,76,0,56.34,10.06,33.6
2021-12-16T00:00:00.000Z,8079,6456595,69.43,8609,5838020,62.78,6552,4161607,44.75,7,83,0,56.53,10.05,33.42
2021-12-17T00:00:00.000Z,4404,6460999,69.48,5134,5843154,62.83,3945,4165552,44.79,3,86,0,56.64,10.05,33.3
2021-12-18T00:00:00.000Z,3940,6464939,69.52,2914,5846068,62.87,1351,4166903,44.81,2,88,0,56.73,10.07,33.2
2021-12-19T00:00:00.000Z,6980,6471919,69.6,9331,5855399,62.97,6266,4173169,44.88,5,93,0,56.92,10.04,33.04
2021-12-20T00:00:00.000Z,7969,6479888,69.68,7514,5862913,63.05,5436,4178605,44.93,9,102,0,57.07,10.02,32.91
2021-12-21T00:00:00.000Z,9547,6489435,69.78,8644,5871557,63.14,6476,4185081,45,8,110,0,57.27,10.01,32.71
2021-12-22T00:00:00.000Z,9665,6499100,69.89,8148,5879705,63.23,6239,4191320,45.07,12,122,0,57.49,10,32.52
2021-12-23T00:00:00.000Z,11540,6510640,70.01,10260,5889965,63.34,8137,4199457,45.16,15,137,0,57.7,9.97,32.33
2021-12-24T00:00:00.000Z,5870,6516510,70.08,6240,5896205,63.4,5272,4204729,45.22,12,149,0,57.83,9.96,32.21
2021-12-25T00:00:00.000Z,3338,6519848,70.11,2565,5898770,63.43,2020,4206749,45.24,6,155,0,57.9,9.96,32.15
2021-12-26T00:00:00.000Z,10653,6530501,70.23,8908,5907678,63.53,8193,4214942,45.33,8,163,0,58.1,9.92,31.98
2021-12-27T00:00:00.000Z,10368,6540869,70.34,7143,5914821,63.61,8182,4223124,45.41,21,184,0,58.27,9.9,31.83
2021-12-28T00:00:00.000Z,11373,6552242,70.46,7451,5922272,63.69,9626,4232750,45.52,24,208,0,58.46,9.88,31.66
2021-12-29T00:00:00.000Z,9935,6562177,70.57,5959,5928231,63.75,8361,4241111,45.61,17,225,0,58.64,9.85,31.51
2021-12-30T00:00:00.000Z,11008,6573185,70.68,7733,5935964,63.83,12236,4253347,45.74,9,234,0,58.84,9.82,31.34
2021-12-31T00:00:00.000Z,4828,6578013,70.74,3671,5939635,63.87,7291,4260638,45.82,134,368,0,58.9,9.79,31.3
2022-01-01T00:00:00.000Z,1992,6580005,70.76,1591,5941226,63.89,2741,4263379,45.85,65,433,0,58.93,9.79,31.28
2022-01-02T00:00:00.000Z,10216,6590221,70.87,6486,5947712,63.96,13000,4276379,45.99,590,1023,0.01,59.14,9.76,31.1
2022-01-03T00:00:00.000Z,9384,6599605,70.97,5256,5952968,64.02,11328,4287707,46.11,25055,26078,0.28,59.29,9.71,31
2022-01-04T00:00:00.000Z,8969,6608574,71.07,5943,5958911,64.08,10517,4298224,46.22,50652,76730,0.83,59.46,9.68,30.86
2022-01-05T00:00:00.000Z,8551,6617125,71.16,5736,5964647,64.14,10486,4308710,46.33,59577,136307,1.47,59.56,9.65,30.79
2022-01-06T00:00:00.000Z,10339,6627464,71.27,7959,5972606,64.23,13528,4322238,46.48,63991,200298,2.15,59.81,9.63,30.56
2022-01-07T00:00:00.000Z,4752,6632216,71.32,4554,5977160,64.28,8151,4330389,46.57,31132,231430,2.49,59.89,9.61,30.49
2022-01-08T00:00:00.000Z,2750,6634966,71.35,2451,5979611,64.3,5500,4335889,46.63,27626,259056,2.79,59.9,9.64,30.46
2022-01-09T00:00:00.000Z,9309,6644275,71.45,7721,5987332,64.38,11861,4347750,46.75,66760,325816,3.5,60.06,9.59,30.35
2022-01-10T00:00:00.000Z,8353,6652628,71.54,7650,5994982,64.47,11864,4359614,46.88,64760,390576,4.2,60.21,9.54,30.25
2022-01-11T00:00:00.000Z,8102,6660730,71.63,8622,6003604,64.56,11962,4371576,47.01,56652,447228,4.81,60.38,9.49,30.13
2022-01-12T00:00:00.000Z,7279,6668009,71.7,8306,6011910,64.65,11104,4382680,47.13,44623,491851,5.29,60.51,9.45,30.04
2022-01-13T00:00:00.000Z,7512,6675521,71.79,9617,6021527,64.75,11536,4394216,47.25,34749,526600,5.66,60.7,9.35,29.94
2022-01-14T00:00:00.000Z,2555,6678076,71.81,4931,6026458,64.81,6138,4400354,47.32,11138,537738,5.78,60.79,9.31,29.9
2022-01-15T00:00:00.000Z,1466,6679542,71.83,3166,6029624,64.84,3878,4404232,47.36,5715,543453,5.84,60.83,9.29,29.87
2022-01-16T00:00:00.000Z,3818,6683360,71.87,8521,6038145,64.93,7677,4411909,47.44,19989,563442,6.06,60.97,9.2,29.82
2022-01-17T00:00:00.000Z,2808,6686168,71.9,7045,6045190,65.01,6164,4418073,47.51,17834,581276,6.25,61.09,9.13,29.78
2022-01-18T00:00:00.000Z,2475,6688643,71.93,7380,6052570,65.09,5522,4423595,47.57,14811,596087,6.41,61.23,9.07,29.7
2022-01-19T00:00:00.000Z,1915,6690558,71.95,6362,6058932,65.15,4514,4428109,47.62,8456,604543,6.5,61.37,8.98,29.65
2022-01-20T00:00:00.000Z,1779,6692337,71.97,6965,6065897,65.23,4785,4432894,47.67,8040,612583,6.59,61.44,8.85,29.71
2022-01-21T00:00:00.000Z,902,6693239,71.98,3725,6069622,65.27,2635,4435529,47.7,3358,615941,6.62,61.51,8.81,29.68
2022-01-22T00:00:00.000Z,328,6693567,71.98,1461,6071083,65.29,1059,4436588,47.71,1113,617054,6.64,61.51,8.75,29.74
2022-01-23T00:00:00.000Z,1067,6694634,71.99,5628,6076711,65.35,2873,4439461,47.74,6080,623134,6.7,61.61,8.7,29.69
2022-01-24T00:00:00.000Z,758,6695392,72,4482,6081193,65.39,2259,4441720,47.76,5054,628188,6.76,61.73,8.62,29.65
2022-01-25T00:00:00.000Z,741,6696133,72.01,4398,6085591,65.44,2171,4443891,47.79,7102,635290,6.83,61.9,8.51,29.59
2022-01-26T00:00:00.000Z,614,6696747,72.01,3283,6088874,65.48,1603,4445494,47.8,4261,639551,6.88,62.02,8.42,29.57
2022-01-27T00:00:00.000Z,797,6697544,72.02,4405,6093279,65.52,2001,4447495,47.83,5439,644990,6.94,62.12,8.35,29.52
2022-01-28T00:00:00.000Z,394,6697938,72.03,2372,6095651,65.55,1169,4448664,47.84,3449,648439,6.97,62.16,8.33,29.5
2022-01-29T00:00:00.000Z,124,6698062,72.03,1045,6096696,65.56,423,4449087,47.84,1160,649599,6.99,62.23,8.29,29.48
2022-01-30T00:00:00.000Z,768,6698830,72.04,4718,6101414,65.61,2016,4451103,47.87,8098,657697,7.07,62.3,8.24,29.46
2022-01-31T00:00:00.000Z,528,6699358,72.04,3185,6104599,65.65,1607,4452710,47.88,6471,664168,7.14,62.39,8.17,29.43
2022-02-01T00:00:00.000Z,477,6699835,72.05,2804,6107403,65.68,1516,4454226,47.9,5719,669887,7.2,62.45,8.15,29.4
2022-02-02T00:00:00.000Z,372,6700207,72.05,2389,6109792,65.7,1376,4455602,47.91,5071,674958,7.26,62.28,8.13,29.59
2022-02-03T00:00:00.000Z,445,6700652,72.06,2775,6112567,65.73,1453,4457055,47.93,5605,680563,7.32,62.34,8.08,29.57
2022-02-04T00:00:00.000Z,174,6700826,72.06,989,6113556,65.74,753,4457808,47.94,2454,683017,7.34,62.37,8.06,29.57
2022-02-05T00:00:00.000Z,62,6700888,72.06,340,6113896,65.75,215,4458023,47.94,420,683437,7.35,62.34,8.09,29.56
2022-02-06T00:00:00.000Z,406,6701294,72.06,2322,6116218,65.77,1342,4459365,47.95,5684,689121,7.41,62.41,8.05,29.55
2022-02-07T00:00:00.000Z,282,6701576,72.07,1306,6117524,65.78,980,4460345,47.96,5960,695081,7.47,62.47,8.01,29.52
2022-02-08T00:00:00.000Z,315,6701891,72.07,1497,6119021,65.8,1062,4461407,47.98,6137,701218,7.54,62.54,7.97,29.49
2022-02-09T00:00:00.000Z,253,6702144,72.07,1102,6120123,65.81,941,4462348,47.99,4570,705788,7.59,62.6,7.95,29.45
2022-02-10T00:00:00.000Z,270,6702414,72.07,1293,6121416,65.83,930,4463278,48,4815,710603,7.64,62.63,7.93,29.44
2022-02-11T00:00:00.000Z,211,6702625,72.08,554,6121970,65.83,513,4463791,48,2534,713137,7.67,62.67,7.91,29.42
2022-02-12T00:00:00.000Z,31,6702656,72.08,90,6122060,65.83,125,4463916,48,268,713405,7.67,62.67,7.91,29.41
2022-02-13T00:00:00.000Z,286,6702942,72.08,945,6123005,65.84,965,4464881,48.01,4995,718400,7.73,62.73,7.87,29.39
2022-02-14T00:00:00.000Z,179,6703121,72.08,625,6123630,65.85,747,4465628,48.02,3143,721543,7.76,62.89,7.74,29.36
2022-02-15T00:00:00.000Z,265,6703386,72.08,764,6124394,65.86,929,4466557,48.03,3815,725358,7.8,62.92,7.73,29.35
2022-02-16T00:00:00.000Z,180,6703566,72.09,576,6124970,65.86,800,4467357,48.04,2487,727845,7.83,62.95,7.72,29.34
2022-02-17T00:00:00.000Z,247,6703813,72.09,738,6125708,65.87,771,4468128,48.05,3057,730902,7.86,62.96,7.7,29.34
2022-02-18T00:00:00.000Z,128,6703941,72.09,333,6126041,65.88,432,4468560,48.05,1118,732020,7.87,62.98,7.69,29.33
2022-02-19T00:00:00.000Z,33,6703974,72.09,83,6126124,65.88,79,4468639,48.05,79,732099,7.87,62.99,7.69,29.32
2022-02-20T00:00:00.000Z,202,6704176,72.09,604,6126728,65.88,717,4469356,48.06,2574,734673,7.9,63.01,7.67,29.32
2022-02-21T00:00:00.000Z,173,6704349,72.1,413,6127141,65.89,488,4469844,48.07,1541,736214,7.92,63.04,7.65,29.31
2022-02-22T00:00:00.000Z,158,6704507,72.1,452,6127593,65.89,561,4470405,48.07,1870,738084,7.94,63.05,7.65,29.3
2022-02-23T00:00:00.000Z,109,6704616,72.1,352,6127945,65.9,450,4470855,48.08,1152,739236,7.95,63.06,7.65,29.29
2022-02-24T00:00:00.000Z,137,6704753,72.1,454,6128399,65.9,563,4471418,48.08,1492,740728,7.97,63.05,7.66,29.29
2022-02-25T00:00:00.000Z,58,6704811,72.1,139,6128538,65.9,188,4471606,48.09,455,741183,7.97,63.06,7.66,29.28
2022-02-26T00:00:00.000Z,15,6704826,72.1,28,6128566,65.9,156,4471762,48.09,35,741218,7.97,63.05,7.67,29.28
2022-02-27T00:00:00.000Z,111,6704937,72.1,340,6128906,65.91,448,4472210,48.09,1118,742336,7.98,63.05,7.67,29.28
2022-02-28T00:00:00.000Z,109,6705046,72.1,270,6129176,65.91,418,4472628,48.1,906,743242,7.99,63.07,7.65,29.28
2022-03-01T00:00:00.000Z,97,6705143,72.1,281,6129457,65.91,371,4472999,48.1,796,744038,8,63.1,7.63,29.27
2022-03-02T00:00:00.000Z,77,6705220,72.1,198,6129655,65.92,323,4473322,48.1,694,744732,8.01,63.11,7.62,29.27
2022-03-03T00:00:00.000Z,156,6705376,72.11,369,6130024,65.92,496,4473818,48.11,985,745717,8.02,63.05,7.67,29.27
2022-03-04T00:00:00.000Z,52,6705428,72.11,166,6130190,65.92,164,4473982,48.11,227,745944,8.02,63.05,7.68,29.27
2022-03-05T00:00:00.000Z,3,6705431,72.11,25,6130215,65.92,43,4474025,48.11,31,745975,8.02,63.04,7.69,29.27
2022-03-06T00:00:00.000Z,98,6705529,72.11,258,6130473,65.92,413,4474438,48.12,759,746734,8.03,63.04,7.69,29.27
2022-03-07T00:00:00.000Z,87,6705616,72.11,259,6130732,65.93,346,4474784,48.12,604,747338,8.04,63.05,7.69,29.26
2022-03-08T00:00:00.000Z,98,6705714,72.11,263,6130995,65.93,333,4475117,48.12,550,747888,8.04,63.04,7.7,29.26
2022-03-09T00:00:00.000Z,88,6705802,72.11,212,6131207,65.93,332,4475449,48.13,492,748380,8.05,63.02,7.72,29.25
2022-03-10T00:00:00.000Z,113,6705915,72.11,373,6131580,65.94,424,4475873,48.13,616,748996,8.05,63.01,7.74,29.25
2022-03-11T00:00:00.000Z,24,6705939,72.11,86,6131666,65.94,121,4475994,48.13,144,749140,8.06,63,7.75,29.25
2022-03-12T00:00:00.000Z,10,6705949,72.11,10,6131676,65.94,31,4476025,48.13,27,749167,8.06,62.98,7.77,29.24
2022-03-13T00:00:00.000Z,100,6706049,72.11,270,6131946,65.94,358,4476383,48.14,594,749761,8.06,62.98,7.78,29.24
2022-03-14T00:00:00.000Z,65,6706114,72.11,252,6132198,65.94,316,4476699,48.14,559,750320,8.07,62.98,7.78,29.24
2022-03-15T00:00:00.000Z,79,6706193,72.12,183,6132381,65.94,291,4476990,48.14,587,750907,8.07,62.95,7.81,29.24
2022-03-16T00:00:00.000Z,74,6706267,72.12,205,6132586,65.95,300,4477290,48.15,669,751576,8.08,62.94,7.82,29.24
2022-03-17T00:00:00.000Z,65,6706332,72.12,121,6132707,65.95,286,4477576,48.15,613,752189,8.09,62.94,7.82,29.24
2022-03-18T00:00:00.000Z,18,6706350,72.12,54,6132761,65.95,99,4477675,48.15,234,752423,8.09,62.94,7.82,29.24
2022-03-19T00:00:00.000Z,5,6706355,72.12,10,6132771,65.95,27,4477702,48.15,38,752461,8.09,62.89,7.88,29.23
2022-03-20T00:00:00.000Z,119,6706474,72.12,258,6133029,65.95,485,4478187,48.16,1428,753889,8.11,62.87,7.89,29.23
2022-03-21T00:00:00.000Z,97,6706571,72.12,246,6133275,65.95,374,4478561,48.16,1132,755021,8.12,62.87,7.9,29.23
2022-03-22T00:00:00.000Z,140,6706711,72.12,341,6133616,65.96,504,4479065,48.17,1769,756790,8.14,62.84,7.94,29.23
2022-03-23T00:00:00.000Z,109,6706820,72.12,210,6133826,65.96,461,4479526,48.17,1674,758464,8.16,62.81,7.97,29.22
2022-03-24T00:00:00.000Z,175,6706995,72.12,344,6134170,65.96,763,4480289,48.18,2359,760823,8.18,62.78,8,29.22
2022-03-25T00:00:00.000Z,38,6707033,72.12,79,6134249,65.96,156,4480445,48.18,628,761451,8.19,62.78,8,29.23
2022-03-26T00:00:00.000Z,12,6707045,72.12,11,6134260,65.96,33,4480478,48.18,91,761542,8.19,62.77,8,29.22
2022-03-27T00:00:00.000Z,165,6707210,72.13,343,6134603,65.97,757,4481235,48.19,3190,764732,8.22,62.75,8.02,29.22
2022-03-28T00:00:00.000Z,113,6707323,72.13,269,6134872,65.97,621,4481856,48.2,2414,767146,8.25,62.75,8.03,29.22
2022-03-29T00:00:00.000Z,125,6707448,72.13,257,6135129,65.97,639,4482495,48.2,2770,769916,8.28,62.7,8.07,29.22
2022-03-30T00:00:00.000Z,132,6707580,72.13,207,6135336,65.98,538,4483033,48.21,2369,772285,8.3,62.81,8.11,29.07
2022-03-31T00:00:00.000Z,166,6707746,72.13,300,6135636,65.98,729,4483762,48.22,2846,775131,8.34,62.79,8.11,29.1
2022-04-01T00:00:00.000Z,121,6707867,72.13,159,6135795,65.98,274,4484036,48.22,583,775714,8.34,62.72,8.13,29.15
2022-04-02T00:00:00.000Z,6,6707873,72.13,6,6135801,65.98,35,4484071,48.22,52,775766,8.34,62.69,8.15,29.16
2022-04-03T00:00:00.000Z,159,6708032,72.13,269,6136070,65.98,570,4484641,48.23,2474,778240,8.37,62.65,8.16,29.19
2022-04-04T00:00:00.000Z,103,6708135,72.14,206,6136276,65.99,482,4485123,48.23,2218,780458,8.39,62.62,8.16,29.22
2022-04-05T00:00:00.000Z,123,6708258,72.14,219,6136495,65.99,512,4485635,48.24,2241,782699,8.42,62.57,8.19,29.25
2022-04-06T00:00:00.000Z,92,6708350,72.14,155,6136650,65.99,381,4486016,48.24,2017,784716,8.44,62.55,8.2,29.25
2022-04-07T00:00:00.000Z,191,6708541,72.14,214,6136864,65.99,641,4486657,48.25,2553,787269,8.47,62.56,8.2,29.24
2022-04-08T00:00:00.000Z,30,6708571,72.14,59,6136923,65.99,151,4486808,48.25,475,787744,8.47,62.54,8.22,29.23
2022-04-09T00:00:00.000Z,6,6708577,72.14,17,6136940,65.99,26,4486834,48.25,46,787790,8.47,62.52,8.25,29.23
2022-04-10T00:00:00.000Z,102,6708679,72.14,264,6137204,66,429,4487263,48.25,1845,789635,8.49,62.51,8.26,29.23
2022-04-11T00:00:00.000Z,78,6708757,72.14,201,6137405,66,370,4487633,48.26,1425,791060,8.51,62.54,8.26,29.2
2022-04-12T00:00:00.000Z,204,6708961,72.14,167,6137572,66,372,4488005,48.26,1359,792419,8.52,62.58,8.29,29.12
2022-04-13T00:00:00.000Z,119,6709080,72.15,150,6137722,66,295,4488300,48.27,1215,793634,8.53,62.58,8.31,29.1
2022-04-14T00:00:00.000Z,84,6709164,72.15,221,6137943,66,320,4488620,48.27,1068,794702,8.55,62.57,8.33,29.1
2022-04-15T00:00:00.000Z,9,6709173,72.15,51,6137994,66,47,4488667,48.27,80,794782,8.55,62.55,8.35,29.1
2022-04-16T00:00:00.000Z,3,6709176,72.15,8,6138002,66,21,4488688,48.27,29,794811,8.55,62.53,8.37,29.1
2022-04-17T00:00:00.000Z,62,6709238,72.15,131,6138133,66.01,228,4488916,48.27,807,795618,8.56,62.52,8.38,29.1
2022-04-18T00:00:00.000Z,68,6709306,72.15,107,6138240,66.01,251,4489167,48.27,749,796367,8.56,62.51,8.38,29.1
2022-04-19T00:00:00.000Z,60,6709366,72.15,143,6138383,66.01,272,4489439,48.28,840,797207,8.57,62.5,8.4,29.1
2022-04-20T00:00:00.000Z,60,6709426,72.15,117,6138500,66.01,234,4489673,48.28,651,797858,8.58,62.48,8.42,29.1
2022-04-21T00:00:00.000Z,52,6709478,72.15,107,6138607,66.01,193,4489866,48.28,479,798337,8.58,62.47,8.43,29.1
2022-04-22T00:00:00.000Z,2,6709480,72.15,16,6138623,66.01,18,4489884,48.28,16,798353,8.59,62.45,8.44,29.11
2022-04-23T00:00:00.000Z,6,6709486,72.15,9,6138632,66.01,14,4489898,48.28,13,798366,8.59,62.43,8.46,29.11
2022-04-24T00:00:00.000Z,92,6709578,72.15,250,6138882,66.01,328,4490226,48.29,869,799235,8.59,62.43,8.47,29.1
2022-04-25T00:00:00.000Z,105,6709683,72.15,191,6139073,66.02,315,4490541,48.29,738,799973,8.6,62.43,8.47,29.1
2022-04-26T00:00:00.000Z,75,6709758,72.15,175,6139248,66.02,302,4490843,48.29,786,800759,8.61,62.42,8.48,29.1
2022-04-27T00:00:00.000Z,55,6709813,72.15,160,6139408,66.02,227,4491070,48.29,638,801397,8.62,62.41,8.49,29.1
2022-04-28T00:00:00.000Z,96,6709909,72.16,232,6139640,66.02,326,4491396,48.3,869,802266,8.63,62.41,8.5,29.1
2022-04-29T00:00:00.000Z,108,6710017,72.16,158,6139798,66.02,182,4491578,48.3,196,802462,8.63,62.39,8.51,29.1
2022-04-30T00:00:00.000Z,1,6710018,72.16,3,6139801,66.02,24,4491602,48.3,19,802481,8.63,62.38,8.52,29.1
2022-05-01T00:00:00.000Z,135,6710153,72.16,185,6139986,66.03,316,4491918,48.3,630,803111,8.64,62.38,8.53,29.09
2022-05-02T00:00:00.000Z,62,6710215,72.16,152,6140138,66.03,235,4492153,48.31,489,803600,8.64,62.37,8.54,29.09
2022-05-03T00:00:00.000Z,72,6710287,72.16,151,6140289,66.03,287,4492440,48.31,505,804105,8.65,62.36,8.55,29.09
2022-05-04T00:00:00.000Z,23,6710310,72.16,55,6140344,66.03,63,4492503,48.31,125,804230,8.65,62.35,8.57,29.08
2022-05-05T00:00:00.000Z,4,6710314,72.16,1,6140345,66.03,3,4492506,48.31,11,804241,8.65,62.34,8.58,29.08
2022-05-06T00:00:00.000Z,19,6710333,72.16,59,6140404,66.03,64,4492570,48.31,151,804392,8.65,62.33,8.59,29.08
2022-05-07T00:00:00.000Z,0,6710333,72.16,6,6140410,66.03,25,4492595,48.31,24,804416,8.65,62.32,8.6,29.08
2022-05-08T00:00:00.000Z,118,6710451,72.16,207,6140617,66.03,270,4492865,48.31,456,804872,8.66,62.31,8.61,29.08
2022-05-09T00:00:00.000Z,59,6710510,72.16,162,6140779,66.03,251,4493116,48.32,502,805374,8.66,62.31,8.61,29.08
2022-05-10T00:00:00.000Z,131,6710641,72.16,168,6140947,66.04,260,4493376,48.32,508,805882,8.67,62.3,8.62,29.08
2022-05-11T00:00:00.000Z,58,6710699,72.16,116,6141063,66.04,179,4493555,48.32,463,806345,8.67,62.3,8.63,29.08
2022-05-12T00:00:00.000Z,118,6710817,72.16,200,6141263,66.04,275,4493830,48.32,663,807008,8.68,62.29,8.64,29.07
2022-05-13T00:00:00.000Z,11,6710828,72.16,42,6141305,66.04,70,4493900,48.33,108,807116,8.68,62.28,8.65,29.07
2022-05-14T00:00:00.000Z,6,6710834,72.17,12,6141317,66.04,10,4493910,48.33,22,807138,8.68,62.26,8.66,29.07
2022-05-15T00:00:00.000Z,91,6710925,72.17,175,6141492,66.04,241,4494151,48.33,663,807801,8.69,62.26,8.67,29.07
2022-05-16T00:00:00.000Z,68,6710993,72.17,142,6141634,66.04,229,4494380,48.33,508,808309,8.69,62.19,8.65,29.16
2022-05-17T00:00:00.000Z,73,6711066,72.17,155,6141789,66.05,265,4494645,48.33,616,808925,8.7,62.18,8.66,29.16
2022-05-18T00:00:00.000Z,43,6711109,72.17,98,6141887,66.05,169,4494814,48.34,445,809370,8.7,62.17,8.67,29.16
2022-05-19T00:00:00.000Z,64,6711173,72.17,170,6142057,66.05,211,4495025,48.34,498,809868,8.71,62.16,8.68,29.16
2022-05-20T00:00:00.000Z,71,6711244,72.17,113,6142170,66.05,127,4495152,48.34,137,810005,8.71,62.15,8.69,29.16
2022-05-21T00:00:00.000Z,4,6711248,72.17,7,6142177,66.05,13,4495165,48.34,18,810023,8.71,62.14,8.7,29.16
2022-05-22T00:00:00.000Z,87,6711335,72.17,188,6142365,66.05,216,4495381,48.34,424,810447,8.72,62.14,8.71,29.16
2022-05-23T00:00:00.000Z,64,6711399,72.17,120,6142485,66.05,154,4495535,48.34,343,810790,8.72,62.14,8.71,29.16
2022-05-24T00:00:00.000Z,43,6711442,72.17,119,6142604,66.05,155,4495690,48.34,393,811183,8.72,62.13,8.71,29.15
2022-05-25T00:00:00.000Z,61,6711503,72.17,103,6142707,66.06,165,4495855,48.35,337,811520,8.73,62.12,8.72,29.15
2022-05-26T00:00:00.000Z,72,6711575,72.17,136,6142843,66.06,184,4496039,48.35,348,811868,8.73,62.11,8.73,29.16
2022-05-27T00:00:00.000Z,11,6711586,72.17,28,6142871,66.06,43,4496082,48.35,59,811927,8.73,62.1,8.74,29.16
2022-05-28T00:00:00.000Z,1,6711587,72.17,4,6142875,66.06,7,4496089,48.35,11,811938,8.73,62.09,8.75,29.16
2022-05-29T00:00:00.000Z,89,6711676,72.17,152,6143027,66.06,163,4496252,48.35,314,812252,8.73,62.09,8.75,29.16
2022-05-30T00:00:00.000Z,56,6711732,72.17,132,6143159,66.06,122,4496374,48.35,291,812543,8.74,62.09,8.76,29.16
2022-05-31T00:00:00.000Z,45,6711777,72.18,104,6143263,66.06,153,4496527,48.35,350,812893,8.74,62.07,8.78,29.15
2022-06-01T00:00:00.000Z,62,6711839,72.18,89,6143352,66.06,117,4496644,48.35,274,813167,8.74,61.95,8.9,29.16
2022-06-02T00:00:00.000Z,76,6711915,72.18,156,6143508,66.06,172,4496816,48.36,254,813421,8.75,45.96,24.88,29.15
2022-06-03T00:00:00.000Z,10,6711925,72.18,23,6143531,66.06,21,4496837,48.36,31,813452,8.75,45.9,24.95,29.16
2022-06-04T00:00:00.000Z,0,6711925,72.18,7,6143538,66.06,7,4496844,48.36,5,813457,8.75,45.84,25,29.16
2022-06-05T00:00:00.000Z,7,6711932,72.18,14,6143552,66.06,6,4496850,48.36,2,813459,8.75,45.8,25.05,29.16
2022-06-06T00:00:00.000Z,58,6711990,72.18,144,6143696,66.07,161,4497011,48.36,262,813721,8.75,39.96,30.89,29.16
2022-06-07T00:00:00.000Z,54,6712044,72.18,133,6143829,66.07,141,4497152,48.36,375,814096,8.75,39.92,30.93,29.15
2022-06-08T00:00:00.000Z,57,6712101,72.18,105,6143934,66.07,130,4497282,48.36,495,814591,8.76,39.89,30.96,29.15
2022-06-09T00:00:00.000Z,84,6712185,72.18,206,6144140,66.07,234,4497516,48.36,641,815232,8.77,39.86,30.99,29.15
2022-06-10T00:00:00.000Z,14,6712199,72.18,51,6144191,66.07,59,4497575,48.36,138,815370,8.77,39.83,31.02,29.15
2022-06-11T00:00:00.000Z,0,6712199,72.18,3,6144194,66.07,7,4497582,48.36,19,815389,8.77,39.8,31.05,29.15
2022-06-12T00:00:00.000Z,105,6712304,72.18,199,6144393,66.07,191,4497773,48.37,767,816156,8.78,39.8,31.05,29.15
2022-06-13T00:00:00.000Z,81,6712385,72.18,142,6144535,66.08,166,4497939,48.37,625,816781,8.78,39.81,31.04,29.15
2022-06-14T00:00:00.000Z,116,6712501,72.18,172,6144707,66.08,208,4498147,48.37,759,817540,8.79,39.79,31.06,29.15
2022-06-15T00:00:00.000Z,72,6712573,72.18,141,6144848,66.08,207,4498354,48.37,696,818236,8.8,39.78,31.08,29.15
2022-06-16T00:00:00.000Z,92,6712665,72.18,136,6144984,66.08,217,4498571,48.38,740,818976,8.81,39.74,31.11,29.14
2022-06-17T00:00:00.000Z,16,6712681,72.18,63,6145047,66.08,52,4498623,48.38,122,819098,8.81,39.72,31.14,29.15
2022-06-18T00:00:00.000Z,3,6712684,72.18,4,6145051,66.08,11,4498634,48.38,15,819113,8.81,39.68,31.17,29.14
2022-06-19T00:00:00.000Z,115,6712799,72.19,206,6145257,66.08,317,4498951,48.38,877,819990,8.82,39.53,31.33,29.15
2022-06-20T00:00:00.000Z,99,6712898,72.19,151,6145408,66.08,306,4499257,48.38,922,820912,8.83,33.92,36.85,29.23
2022-06-21T00:00:00.000Z,94,6712992,72.19,154,6145562,66.09,375,4499632,48.39,1228,822140,8.84,33.58,37.19,29.23
2022-06-22T00:00:00.000Z,110,6713102,72.19,133,6145695,66.09,339,4499971,48.39,894,823034,8.85,33.28,37.49,29.23
2022-06-23T00:00:00.000Z,132,6713234,72.19,216,6145911,66.09,523,4500494,48.4,1146,824180,8.86,32.84,37.92,29.23
2022-06-24T00:00:00.000Z,19,6713253,72.19,35,6145946,66.09,109,4500603,48.4,207,824387,8.87,32.43,38.34,29.24
2022-06-25T00:00:00.000Z,1,6713254,72.19,1,6145947,66.09,12,4500615,48.4,16,824403,8.87,32.04,38.72,29.24
2022-06-26T00:00:00.000Z,107,6713361,72.19,158,6146105,66.09,379,4500994,48.4,933,825336,8.88,31.63,39.13,29.24
2022-06-27T00:00:00.000Z,85,6713446,72.19,172,6146277,66.09,391,4501385,48.41,1027,826363,8.89,31.29,39.47,29.24
2022-06-28T00:00:00.000Z,84,6713530,72.19,151,6146428,66.1,362,4501747,48.41,930,827293,8.9,30.86,39.91,29.24
2022-06-29T00:00:00.000Z,76,6713606,72.19,106,6146534,66.1,261,4502008,48.41,813,828106,8.91,30.48,40.28,29.24
2022-06-30T00:00:00.000Z,84,6713690,72.2,164,6146698,66.1,355,4502363,48.42,1057,829163,8.92,30.05,40.71,29.24
2022-07-01T00:00:00.000Z,21,6713711,72.2,28,6146726,66.1,54,4502417,48.42,77,829240,8.92,29.62,41.14,29.24
2022-07-02T00:00:00.000Z,0,6713711,72.2,2,6146728,66.1,6,4502423,48.42,18,829258,8.92,29.2,41.56,29.24
2022-07-03T00:00:00.000Z,85,6713796,72.2,172,6146900,66.1,318,4502741,48.42,636,829894,8.92,28.81,41.95,29.24
2022-07-04T00:00:00.000Z,77,6713873,72.2,140,6147040,66.1,275,4503016,48.42,746,830640,8.93,28.5,42.26,29.24
2022-07-05T00:00:00.000Z,58,6713931,72.2,142,6147182,66.1,301,4503317,48.43,688,831328,8.94,28.06,42.7,29.24
2022-07-06T00:00:00.000Z,77,6714008,72.2,125,6147307,66.11,212,4503529,48.43,643,831971,8.95,27.39,43.37,29.24
2022-07-07T00:00:00.000Z,81,6714089,72.2,164,6147471,66.11,265,4503794,48.43,722,832693,8.95,26.48,44.28,29.24
2022-07-08T00:00:00.000Z,17,6714106,72.2,33,6147504,66.11,68,4503862,48.43,131,832824,8.96,25.47,45.29,29.24
2022-07-09T00:00:00.000Z,0,6714106,72.2,1,6147505,66.11,1,4503863,48.43,1,832825,8.96,24.42,46.34,29.24
2022-07-10T00:00:00.000Z,85,6714191,72.2,164,6147669,66.11,230,4504093,48.43,469,833294,8.96,23.77,46.99,29.24
2022-07-11T00:00:00.000Z,65,6714256,72.2,140,6147809,66.11,244,4504337,48.44,571,833865,8.97,23.22,47.54,29.24
2022-07-12T00:00:00.000Z,69,6714325,72.2,128,6147937,66.11,207,4504544,48.44,556,834421,8.97,22.13,48.63,29.24
2022-07-13T00:00:00.000Z,43,6714368,72.2,100,6148037,66.11,163,4504707,48.44,488,834909,8.98,21.1,49.66,29.24
2022-07-14T00:00:00.000Z,69,6714437,72.2,147,6148184,66.11,207,4504914,48.44,511,835420,8.98,20.12,50.63,29.24
2022-07-15T00:00:00.000Z,57,6714494,72.2,78,6148262,66.12,129,4505043,48.45,166,835586,8.99,19.27,51.48,29.25
2022-07-16T00:00:00.000Z,0,6714494,72.2,6,6148268,66.12,7,4505050,48.45,7,835593,8.99,18.29,52.46,29.25
2022-07-17T00:00:00.000Z,75,6714569,72.21,180,6148448,66.12,241,4505291,48.45,468,836061,8.99,17.83,52.92,29.25
2022-07-18T00:00:00.000Z,62,6714631,72.21,157,6148605,66.12,206,4505497,48.45,510,836571,9,17.48,53.26,29.26
2022-07-19T00:00:00.000Z,61,6714692,72.21,146,6148751,66.12,173,4505670,48.45,368,836939,9,16.77,53.97,29.26
2022-07-20T00:00:00.000Z,51,6714743,72.21,135,6148886,66.12,135,4505805,48.45,421,837360,9,16.09,54.64,29.26
2022-07-21T00:00:00.000Z,64,6714807,72.21,152,6149038,66.12,175,4505980,48.46,340,837700,9.01,15.43,55.3,29.27
2022-07-22T00:00:00.000Z,10,6714817,72.21,36,6149074,66.12,41,4506021,48.46,56,837756,9.01,14.64,56.08,29.28
2022-07-23T00:00:00.000Z,0,6714817,72.21,3,6149077,66.12,2,4506023,48.46,9,837765,9.01,14.17,56.55,29.28
2022-07-24T00:00:00.000Z,58,6714875,72.21,125,6149202,66.13,197,4506220,48.46,363,838128,9.01,13.55,57.16,29.29
2022-07-25T00:00:00.000Z,48,6714923,72.21,105,6149307,66.13,170,4506390,48.46,334,838462,9.02,13.09,57.61,29.3
2022-07-26T00:00:00.000Z,47,6714970,72.21,100,6149407,66.13,108,4506498,48.46,270,838732,9.02,12.46,58.23,29.3
2022-07-27T00:00:00.000Z,45,6715015,72.21,124,6149531,66.13,131,4506629,48.46,242,838974,9.02,11.89,58.8,29.31
2022-07-28T00:00:00.000Z,62,6715077,72.21,140,6149671,66.13,147,4506776,48.46,219,839193,9.02,11.35,59.34,29.31
2022-07-29T00:00:00.000Z,10,6715087,72.21,25,6149696,66.13,27,4506803,48.46,30,839223,9.02,10.85,59.83,29.32
2022-07-30T00:00:00.000Z,0,6715087,72.21,0,6149696,66.13,1,4506804,48.46,1,839224,9.02,10.34,60.33,29.33
2022-07-31T00:00:00.000Z,58,6715145,72.21,133,6149829,66.13,131,4506935,48.47,251,839475,9.03,9.97,60.7,29.33
2022-08-01T00:00:00.000Z,54,6715199,72.21,75,6149904,66.13,88,4507023,48.47,153,839628,9.03,9.47,61.19,29.34
2022-08-02T00:00:00.000Z,111,6715310,72.21,119,6150023,66.13,155,4507178,48.47,264,839892,9.03,8.92,61.73,29.35
2022-08-03T00:00:00.000Z,76,6715386,72.21,70,6150093,66.14,92,4507270,48.47,177,840069,9.03,8.46,62.19,29.35
2022-08-04T00:00:00.000Z,125,6715511,72.22,131,6150224,66.14,111,4507381,48.47,244,840313,9.04,8.04,62.61,29.36
2022-08-05T00:00:00.000Z,30,6715541,72.22,22,6150246,66.14,13,4507394,48.47,23,840336,9.04,7.71,62.93,29.36
2022-08-06T00:00:00.000Z,1,6715542,72.22,2,6150248,66.14,1,4507395,48.47,4,840340,9.04,7.32,63.32,29.36
2022-08-07T00:00:00.000Z,76,6715618,72.22,81,6150329,66.14,66,4507461,48.47,168,840508,9.04,6.92,63.71,29.37
2022-08-08T00:00:00.000Z,76,6715694,72.22,92,6150421,66.14,122,4507583,48.47,170,840678,9.04,6.74,63.89,29.37
2022-08-09T00:00:00.000Z,98,6715792,72.22,87,6150508,66.14,98,4507681,48.47,212,840890,9.04,6.25,64.37,29.38
2022-08-10T00:00:00.000Z,78,6715870,72.22,57,6150565,66.14,71,4507752,48.47,115,841005,9.04,5.91,64.71,29.38
2022-08-11T00:00:00.000Z,53,6715923,72.22,100,6150665,66.14,91,4507843,48.48,154,841159,9.05,5.59,65.03,29.38
2022-08-12T00:00:00.000Z,8,6715931,72.22,12,6150677,66.14,17,4507860,48.48,27,841186,9.05,5.35,65.27,29.38
2022-08-13T00:00:00.000Z,0,6715931,72.22,1,6150678,66.14,2,4507862,48.48,3,841189,9.05,5.1,65.52,29.38
2022-08-14T00:00:00.000Z,73,6716004,72.22,74,6150752,66.14,82,4507944,48.48,150,841339,9.05,4.87,65.75,29.39
2022-08-15T00:00:00.000Z,69,6716073,72.22,81,6150833,66.14,92,4508036,48.48,142,841481,9.05,4.74,65.87,29.39
2022-08-16T00:00:00.000Z,81,6716154,72.22,84,6150917,66.14,83,4508119,48.48,186,841667,9.05,4.47,66.15,29.39
2022-08-17T00:00:00.000Z,48,6716202,72.22,55,6150972,66.14,36,4508155,48.48,114,841781,9.05,4.16,66.44,29.39
2022-08-18T00:00:00.000Z,64,6716266,72.22,93,6151065,66.15,119,4508274,48.48,173,841954,9.05,3.98,66.63,29.39
2022-08-19T00:00:00.000Z,74,6716340,72.22,55,6151120,66.15,54,4508328,48.48,45,841999,9.05,3.83,66.78,29.39
2022-08-20T00:00:00.000Z,1,6716341,72.22,1,6151121,66.15,3,4508331,48.48,3,842002,9.05,3.67,66.94,29.39
2022-08-21T00:00:00.000Z,51,6716392,72.22,85,6151206,66.15,84,4508415,48.48,193,842195,9.06,3.52,67.08,29.4
2022-08-22T00:00:00.000Z,89,6716481,72.23,74,6151280,66.15,102,4508517,48.48,142,842337,9.06,3.44,67.16,29.4
2022-08-23T00:00:00.000Z,73,6716554,72.23,106,6151386,66.15,84,4508601,48.48,177,842514,9.06,3.27,67.33,29.4
2022-08-24T00:00:00.000Z,40,6716594,72.23,78,6151464,66.15,50,4508651,48.48,132,842646,9.06,3.15,67.46,29.4
2022-08-25T00:00:00.000Z,54,6716648,72.23,75,6151539,66.15,91,4508742,48.48,190,842836,9.06,3.03,67.57,29.4
2022-08-26T00:00:00.000Z,0,6716648,72.23,0,6151539,66.15,0,4508742,48.48,0,842836,9.06,2.94,67.66,29.4
