Day_Date,vaccinated,vaccinated_cum,vaccinated_population_perc,vaccinated_seconde_dose,vaccinated_seconde_dose_cum,vaccinated_seconde_dose_population_perc,vaccinated_third_dose,vaccinated_third_dose_cum,vaccinated_third_dose_population_perc,vaccinated_fourth_dose,vaccinated_fourth_dose_cum,vaccinated_fourth_dose_population_perc,vaccinated_validity_perc,vaccinated_expired_perc,not_vaccinated_perc
2020-12-19T00:00:00.000Z,46,66,0,0,4,0,0,0,0,0,0,0,0,0,100
2020-12-20T00:00:00.000Z,7390,7456,0.08,0,4,0,0,0,0,0,0,0,0,0,100
2020-12-21T00:00:00.000Z,24917,32373,0.35,0,4,0,0,0,0,0,0,0,0,0,100
2020-12-22T00:00:00.000Z,44653,77026,0.83,0,4,0,0,0,0,0,0,0,0,0,100
2020-12-23T00:00:00.000Z,62900,139926,1.5,0,4,0,0,0,0,0,0,0,0,0,100
2020-12-24T00:00:00.000Z,73412,213338,2.29,0,4,0,0,0,0,0,0,0,0,0,100
2020-12-25T00:00:00.000Z,38505,251843,2.71,0,4,0,0,0,0,0,0,0,0,0,100
2020-12-26T00:00:00.000Z,32609,284452,3.06,0,4,0,0,0,0,0,0,0,0,0,100
2020-12-27T00:00:00.000Z,104543,388995,4.18,0,4,0,0,0,0,0,0,0,0,0,100
2020-12-28T00:00:00.000Z,134990,523985,5.63,0,4,0,0,0,0,0,0,0,0,0,100
2020-12-29T00:00:00.000Z,156258,680243,7.32,2,6,0,0,0,0,0,0,0,0,0,100
2020-12-30T00:00:00.000Z,153107,833350,8.96,0,6,0,0,0,0,0,0,0,0,0,100
2020-12-31T00:00:00.000Z,158512,991862,10.67,0,6,0,0,0,0,0,0,0,0,0,100
2021-01-01T00:00:00.000Z,71403,1063265,11.43,0,6,0,0,0,0,0,0,0,0,0,100
2021-01-02T00:00:00.000Z,71709,1134974,12.21,0,6,0,0,0,0,0,0,0,0,0,100
2021-01-03T00:00:00.000Z,149698,1284672,13.81,0,6,0,0,0,0,0,0,0,0,0,100
2021-01-04T00:00:00.000Z,152142,1436814,15.45,1,7,0,0,0,0,0,0,0,0,0,100
2021-01-05T00:00:00.000Z,125140,1561954,16.8,3,10,0,0,0,0,0,0,0,0,0,100
2021-01-06T00:00:00.000Z,103294,1665248,17.91,2,12,0,0,0,0,0,0,0,0,0,100
2021-01-07T00:00:00.000Z,115992,1781240,19.15,7,19,0,0,0,0,0,0,0,0,0,100
2021-01-08T00:00:00.000Z,66421,1847661,19.87,4,23,0,0,0,0,0,0,0,0,0,100
2021-01-09T00:00:00.000Z,44518,1892179,20.35,24,47,0,0,0,0,0,0,0,0,0,100
2021-01-10T00:00:00.000Z,37629,1929808,20.75,5997,6044,0.07,0,0,0,0,0,0,0,0,100
2021-01-11T00:00:00.000Z,21145,1950953,20.98,19259,25303,0.27,0,0,0,0,0,0,0,0,100
2021-01-12T00:00:00.000Z,24042,1974995,21.24,35666,60969,0.66,0,0,0,0,0,0,0,0,100
2021-01-13T00:00:00.000Z,52032,2027027,21.8,56861,117830,1.27,0,0,0,0,0,0,0,0,100
2021-01-14T00:00:00.000Z,56427,2083454,22.4,68826,186656,2.01,0,0,0,0,0,0,0,0,100
2021-01-15T00:00:00.000Z,30743,2114197,22.73,35927,222583,2.39,0,0,0,0,0,0,0,0,100
2021-01-16T00:00:00.000Z,29451,2143648,23.05,26004,248587,2.67,0,0,0,0,0,0,0,0,100
2021-01-17T00:00:00.000Z,68405,2212053,23.79,84579,333166,3.58,0,0,0,0,0,0,0.36,0,99.64
2021-01-18T00:00:00.000Z,69760,2281813,24.54,120402,453568,4.88,0,0,0,0,0,0,0.64,0,99.36
2021-01-19T00:00:00.000Z,72848,2354661,25.32,137807,591375,6.36,0,0,0,0,0,0,1.16,0,98.84
2021-01-20T00:00:00.000Z,76856,2431517,26.15,143717,735092,7.9,0,0,0,0,0,0,1.98,0,98.02
2021-01-21T00:00:00.000Z,69956,2501473,26.9,164395,899487,9.67,0,0,0,0,0,0,2.98,0,97.02
2021-01-22T00:00:00.000Z,37891,2539364,27.31,71110,970597,10.44,0,0,0,0,0,0,3.5,0,96.5
2021-01-23T00:00:00.000Z,39948,2579312,27.74,53568,1024165,11.01,0,0,0,0,0,0,3.89,0,96.11
2021-01-24T00:00:00.000Z,69098,2648410,28.48,140663,1164828,12.53,0,0,0,0,0,0,5.1,0,94.9
2021-01-25T00:00:00.000Z,80893,2729303,29.35,139478,1304306,14.03,0,0,0,0,0,0,6.78,0,93.22
2021-01-26T00:00:00.000Z,78682,2807985,30.2,126387,1430693,15.38,0,0,0,0,0,0,8.65,0,91.35
2021-01-27T00:00:00.000Z,77929,2885914,31.03,125020,1555713,16.73,0,0,0,0,0,0,10.56,0,89.44
2021-01-28T00:00:00.000Z,79531,2965445,31.89,130575,1686288,18.13,0,0,0,0,0,0,12.69,0,87.31
2021-01-29T00:00:00.000Z,36667,3002112,32.28,64767,1751055,18.83,0,0,0,0,0,0,13.61,0,86.39
2021-01-30T00:00:00.000Z,34383,3036495,32.65,42748,1793803,19.29,0,0,0,0,0,0,14.3,0,85.7
2021-01-31T00:00:00.000Z,73310,3109805,33.44,59479,1853282,19.93,0,0,0,0,0,0,16.07,0,83.93
2021-02-01T00:00:00.000Z,82466,3192271,34.33,35326,1888608,20.31,0,0,0,0,0,0,17.81,0,82.19
2021-02-02T00:00:00.000Z,70058,3262329,35.08,31049,1919657,20.64,0,0,0,0,0,0,19.35,0,80.65
2021-02-03T00:00:00.000Z,60273,3322602,35.73,51412,1971069,21.2,0,0,0,0,0,0,20.84,0,79.16
2021-02-04T00:00:00.000Z,72594,3395196,36.51,58066,2029135,21.82,0,0,0,0,0,0,22.39,0,77.61
2021-02-05T00:00:00.000Z,33911,3429107,36.87,28781,2057916,22.13,0,0,0,0,0,0,23.15,0,76.85
2021-02-06T00:00:00.000Z,21600,3450707,37.11,22221,2080137,22.37,0,0,0,0,0,0,23.64,0,76.36
2021-02-07T00:00:00.000Z,54064,3504771,37.69,68708,2148845,23.11,0,0,0,0,0,0,24.4,0,75.6
2021-02-08T00:00:00.000Z,58610,3563381,38.32,65438,2214283,23.81,0,0,0,0,0,0,24.95,0,75.05
2021-02-09T00:00:00.000Z,66309,3629690,39.03,67539,2281822,24.54,0,0,0,0,0,0,25.48,0,74.52
2021-02-10T00:00:00.000Z,70528,3700218,39.79,72273,2354095,25.31,0,0,0,0,0,0,26.23,0,73.77
2021-02-11T00:00:00.000Z,81137,3781355,40.66,72073,2426168,26.09,0,0,0,0,0,0,27.08,0,72.92
2021-02-12T00:00:00.000Z,39078,3820433,41.08,37563,2463731,26.49,0,0,0,0,0,0,27.5,0,72.5
2021-02-13T00:00:00.000Z,27448,3847881,41.38,30423,2494154,26.82,0,0,0,0,0,0,27.82,0,72.18
2021-02-14T00:00:00.000Z,74883,3922764,42.18,69054,2563208,27.56,0,0,0,0,0,0,28.76,0,71.24
2021-02-15T00:00:00.000Z,81510,4004274,43.06,75674,2638882,28.38,0,0,0,0,0,0,29.69,0,70.31
2021-02-16T00:00:00.000Z,83392,4087666,43.96,78253,2717135,29.22,0,0,0,0,0,0,30.64,0,69.36
2021-02-17T00:00:00.000Z,61951,4149617,44.62,75600,2792735,30.03,0,0,0,0,0,0,31.56,0,68.44
2021-02-18T00:00:00.000Z,69124,4218741,45.37,79712,2872447,30.89,0,0,0,0,0,0,32.51,0,67.49
2021-02-19T00:00:00.000Z,39647,4258388,45.79,38129,2910576,31.3,0,0,0,0,0,0,33.02,0,66.98
2021-02-20T00:00:00.000Z,31643,4290031,46.13,28716,2939292,31.61,0,0,0,0,0,0,33.43,0,66.57
2021-02-21T00:00:00.000Z,79411,4369442,46.99,78422,3017714,32.45,0,0,0,0,0,0,34.39,0,65.61
2021-02-22T00:00:00.000Z,85031,4454473,47.9,80574,3098288,33.32,0,0,0,0,0,0,35.44,0,64.56
2021-02-23T00:00:00.000Z,77305,4531778,48.73,70450,3168738,34.08,0,0,0,0,0,0,36.47,0,63.53
2021-02-24T00:00:00.000Z,61036,4592814,49.39,63105,3231843,34.75,0,0,0,0,0,0,37.4,0,62.6
2021-02-25T00:00:00.000Z,51698,4644512,49.94,64777,3296620,35.45,0,0,0,0,0,0,38.31,0,61.69
2021-02-26T00:00:00.000Z,25887,4670399,50.22,32014,3328634,35.79,0,0,0,0,0,0,38.76,0,61.24
2021-02-27T00:00:00.000Z,18333,4688732,50.42,21186,3349820,36.02,0,0,0,0,0,0,39.08,0,60.92
2021-02-28T00:00:00.000Z,40336,4729068,50.85,55858,3405678,36.62,0,0,0,0,0,0,39.92,0,60.08
2021-03-01T00:00:00.000Z,45712,4774780,51.35,61414,3467092,37.28,0,0,0,0,0,0,40.78,0,59.22
2021-03-02T00:00:00.000Z,41155,4815935,51.79,64762,3531854,37.98,0,0,0,0,0,0,41.54,0,58.46
2021-03-03T00:00:00.000Z,41992,4857927,52.24,66751,3598605,38.7,0,0,0,0,0,0,42.25,0,57.75
2021-03-04T00:00:00.000Z,39680,4897607,52.67,79095,3677700,39.55,0,0,0,0,0,0,42.95,0,57.05
2021-03-05T00:00:00.000Z,17329,4914936,52.85,40446,3718146,39.98,0,0,0,0,0,0,43.28,0,56.72
2021-03-06T00:00:00.000Z,10697,4925633,52.97,25337,3743483,40.26,0,0,0,0,0,0,43.5,0,56.5
2021-03-07T00:00:00.000Z,31126,4956759,53.3,72821,3816304,41.04,0,0,0,0,0,0,44.09,0,55.91
2021-03-08T00:00:00.000Z,27346,4984105,53.6,73266,3889570,41.83,0,0,0,0,0,0,44.71,0,55.29
2021-03-09T00:00:00.000Z,26716,5010821,53.88,76578,3966148,42.65,0,0,0,0,0,0,45.37,0,54.63
2021-03-10T00:00:00.000Z,23319,5034140,54.13,58653,4024801,43.28,0,0,0,0,0,0,46.03,0,53.97
2021-03-11T00:00:00.000Z,23271,5057411,54.38,69065,4093866,44.02,0,0,0,0,0,0,46.76,0,53.24
2021-03-12T00:00:00.000Z,11247,5068658,54.51,41395,4135261,44.47,0,0,0,0,0,0,47.12,0,52.88
2021-03-13T00:00:00.000Z,7925,5076583,54.59,25233,4160494,44.74,0,0,0,0,0,0,47.35,0,52.65
2021-03-14T00:00:00.000Z,20952,5097535,54.82,73922,4234416,45.53,0,0,0,0,0,0,47.99,0,52.01
2021-03-15T00:00:00.000Z,20110,5117645,55.03,78250,4312666,46.38,0,0,0,0,0,0,48.61,0,51.39
2021-03-16T00:00:00.000Z,18721,5136366,55.23,71454,4384120,47.14,0,0,0,0,0,0,49.23,0,50.77
2021-03-17T00:00:00.000Z,17665,5154031,55.42,58983,4443103,47.78,0,0,0,0,0,0,49.72,0,50.28
2021-03-18T00:00:00.000Z,16013,5170044,55.6,58107,4501210,48.4,0,0,0,0,0,0,50.26,0,49.74
2021-03-19T00:00:00.000Z,6920,5176964,55.67,27964,4529174,48.7,0,0,0,0,0,0,50.56,0,49.44
2021-03-20T00:00:00.000Z,5205,5182169,55.73,15287,4544461,48.87,0,0,0,0,0,0,50.74,0,49.26
2021-03-21T00:00:00.000Z,13142,5195311,55.87,40482,4584943,49.3,0,0,0,0,0,0,51.27,0,48.73
2021-03-22T00:00:00.000Z,13546,5208857,56.01,40513,4625456,49.74,0,0,0,0,0,0,51.81,0,48.19
2021-03-23T00:00:00.000Z,2807,5211664,56.04,7276,4632732,49.82,0,0,0,0,0,0,52.24,0,47.76
2021-03-24T00:00:00.000Z,10980,5222644,56.16,46527,4679259,50.32,0,0,0,0,0,0,52.65,0,47.35
2021-03-25T00:00:00.000Z,10227,5232871,56.27,35405,4714664,50.7,0,0,0,0,0,0,53.04,0,46.96
2021-03-26T00:00:00.000Z,4159,5237030,56.32,13313,4727977,50.84,0,0,0,0,0,0,53.22,0,46.78
2021-03-27T00:00:00.000Z,1770,5238800,56.34,4256,4732233,50.89,0,0,0,0,0,0,53.31,0,46.69
2021-03-28T00:00:00.000Z,2096,5240896,56.36,4598,4736831,50.94,0,0,0,0,0,0,53.55,0,46.45
2021-03-29T00:00:00.000Z,6884,5247780,56.43,29996,4766827,51.26,0,0,0,0,0,0,53.81,0,46.19
2021-03-30T00:00:00.000Z,7852,5255632,56.52,22414,4789241,51.5,0,0,0,0,0,0,53.9,0,46.1
2021-03-31T00:00:00.000Z,8121,5263753,56.6,19452,4808693,51.71,0,0,0,0,0,0,54.2,0,45.8
2021-04-01T00:00:00.000Z,8161,5271914,56.69,18672,4827365,51.91,0,0,0,0,0,0,54.43,0,45.57
2021-04-02T00:00:00.000Z,2912,5274826,56.72,8109,4835474,52,0,0,0,0,0,0,54.52,0,45.48
2021-04-03T00:00:00.000Z,1411,5276237,56.74,2956,4838430,52.03,0,0,0,0,0,0,54.55,0,45.45
2021-04-04T00:00:00.000Z,9609,5285846,56.84,22815,4861245,52.28,0,0,0,0,0,0,54.64,0,45.36
2021-04-05T00:00:00.000Z,10324,5296170,56.95,21236,4882481,52.5,0,0,0,0,0,0,54.86,0,45.14
2021-04-06T00:00:00.000Z,8993,5305163,57.05,16756,4899237,52.68,0,0,0,0,0,0,55.03,0,44.97
2021-04-07T00:00:00.000Z,8891,5314054,57.14,15267,4914504,52.85,0,0,0,0,0,0,55.18,0,44.82
2021-04-08T00:00:00.000Z,9382,5323436,57.25,16975,4931479,53.03,0,0,0,0,0,0,55.34,0,44.66
2021-04-09T00:00:00.000Z,3573,5327009,57.28,6212,4937691,53.1,0,0,0,0,0,0,55.4,0,44.6
2021-04-10T00:00:00.000Z,1616,5328625,57.3,3502,4941193,53.14,0,0,0,0,0,0,55.43,0,44.57
2021-04-11T00:00:00.000Z,9016,5337641,57.4,14221,4955414,53.29,0,0,0,0,0,0,55.61,0,44.39
2021-04-12T00:00:00.000Z,8904,5346545,57.49,13205,4968619,53.43,0,0,0,0,0,0,55.77,0,44.23
2021-04-13T00:00:00.000Z,5802,5352347,57.56,4926,4973545,53.48,0,0,0,0,0,0,55.9,0,44.1
2021-04-14T00:00:00.000Z,3614,5355961,57.6,5278,4978823,53.54,0,0,0,0,0,0,56,0,44
2021-04-15T00:00:00.000Z,668,5356629,57.6,556,4979379,53.55,0,0,0,0,0,0,56.1,0,43.9
2021-04-16T00:00:00.000Z,3378,5360007,57.64,6623,4986002,53.62,0,0,0,0,0,0,56.15,0,43.85
2021-04-17T00:00:00.000Z,804,5360811,57.65,1959,4987961,53.64,0,0,0,0,0,0,56.17,0,43.83
2021-04-18T00:00:00.000Z,7083,5367894,57.72,7418,4995379,53.72,0,0,0,0,0,0,56.29,0,43.71
2021-04-19T00:00:00.000Z,6373,5374267,57.79,7099,5002478,53.79,0,0,0,0,0,0,56.4,0,43.6
2021-04-20T00:00:00.000Z,6250,5380517,57.86,6851,5009329,53.87,0,0,0,0,0,0,56.47,0,43.53
2021-04-21T00:00:00.000Z,6346,5386863,57.93,7072,5016401,53.94,0,0,0,0,0,0,56.54,0,43.46
2021-04-22T00:00:00.000Z,5917,5392780,57.99,7662,5024063,54.03,0,0,0,0,0,0,56.58,0,43.42
2021-04-23T00:00:00.000Z,2738,5395518,58.02,3362,5027425,54.06,0,0,0,0,0,0,56.63,0,43.37
2021-04-24T00:00:00.000Z,755,5396273,58.03,1276,5028701,54.08,0,0,0,0,0,0,56.64,0,43.36
2021-04-25T00:00:00.000Z,4818,5401091,58.08,6906,5035607,54.15,0,0,0,0,0,0,56.71,0,43.29
2021-04-26T00:00:00.000Z,5458,5406549,58.14,7868,5043475,54.23,0,0,0,0,0,0,56.79,0,43.21
2021-04-27T00:00:00.000Z,4486,5411035,58.19,6600,5050075,54.31,0,0,0,0,0,0,56.85,0,43.15
2021-04-28T00:00:00.000Z,4465,5415500,58.24,7286,5057361,54.38,0,0,0,0,0,0,56.92,0,43.08
2021-04-29T00:00:00.000Z,4342,5419842,58.28,7251,5064612,54.46,0,0,0,0,0,0,56.99,0,43.01
2021-04-30T00:00:00.000Z,1900,5421742,58.3,3162,5067774,54.5,0,0,0,0,0,0,57.02,0,42.98
2021-05-01T00:00:00.000Z,446,5422188,58.31,885,5068659,54.51,0,0,0,0,0,0,57.03,0,42.97
2021-05-02T00:00:00.000Z,3215,5425403,58.34,6068,5074727,54.57,0,0,0,0,0,0,57.08,0,42.92
2021-05-03T00:00:00.000Z,3526,5428929,58.38,5791,5080518,54.63,0,0,0,0,0,0,57.15,0,42.85
2021-05-04T00:00:00.000Z,3561,5432490,58.42,4701,5085219,54.68,0,0,0,0,0,0,57.2,0,42.8
2021-05-05T00:00:00.000Z,3268,5435758,58.45,4057,5089276,54.73,0,0,0,0,0,0,57.26,0,42.74
2021-05-06T00:00:00.000Z,3615,5439373,58.49,3101,5092377,54.76,0,0,0,0,0,0,57.32,0,42.68
2021-05-07T00:00:00.000Z,1806,5441179,58.51,2473,5094850,54.79,0,0,0,0,0,0,57.35,0,42.65
2021-05-08T00:00:00.000Z,230,5441409,58.51,492,5095342,54.79,0,0,0,0,0,0,57.35,0,42.65
2021-05-09T00:00:00.000Z,2836,5444245,58.54,4735,5100077,54.84,0,0,0,0,0,0,57.4,0,42.6
2021-05-10T00:00:00.000Z,2881,5447126,58.58,4679,5104756,54.89,0,0,0,0,0,0,57.45,0,42.55
2021-05-11T00:00:00.000Z,2602,5449728,58.6,3851,5108607,54.94,0,0,0,0,0,0,57.49,0,42.51
2021-05-12T00:00:00.000Z,1997,5451725,58.63,3307,5111914,54.97,0,0,0,0,0,0,57.53,0,42.47
2021-05-13T00:00:00.000Z,2025,5453750,58.65,3651,5115565,55.01,0,0,0,0,0,0,57.56,0,42.44
2021-05-14T00:00:00.000Z,950,5454700,58.66,1469,5117034,55.03,0,0,0,0,0,0,57.57,0,42.43
2021-05-15T00:00:00.000Z,236,5454936,58.66,238,5117272,55.03,0,0,0,0,0,0,57.58,0,42.42
2021-05-16T00:00:00.000Z,522,5455458,58.67,1196,5118468,55.04,0,0,0,0,0,0,57.6,0,42.4
2021-05-17T00:00:00.000Z,286,5455744,58.67,830,5119298,55.05,0,0,0,0,0,0,57.63,0,42.37
2021-05-18T00:00:00.000Z,1943,5457687,58.69,4920,5124218,55.1,0,0,0,0,0,0,57.66,0,42.34
2021-05-19T00:00:00.000Z,2203,5459890,58.71,5018,5129236,55.16,0,0,0,0,0,0,57.69,0,42.31
2021-05-20T00:00:00.000Z,2296,5462186,58.74,3859,5133095,55.2,0,0,0,0,0,0,57.72,0,42.28
2021-05-21T00:00:00.000Z,1163,5463349,58.75,1381,5134476,55.21,0,0,0,0,0,0,57.74,0,42.26
2021-05-22T00:00:00.000Z,203,5463552,58.75,383,5134859,55.22,0,0,0,0,0,0,57.74,0,42.26
2021-05-23T00:00:00.000Z,2266,5465818,58.78,3208,5138067,55.25,0,0,0,0,0,0,57.76,0,42.24
2021-05-24T00:00:00.000Z,2111,5467929,58.8,3578,5141645,55.29,0,0,0,0,0,0,57.78,0,42.22
2021-05-25T00:00:00.000Z,1805,5469734,58.82,2567,5144212,55.32,0,0,0,0,0,0,57.81,0,42.19
2021-05-26T00:00:00.000Z,1389,5471123,58.83,2475,5146687,55.34,0,0,0,0,0,0,57.85,0,42.15
2021-05-27T00:00:00.000Z,1823,5472946,58.85,3162,5149849,55.38,0,0,0,0,0,0,57.88,0,42.12
2021-05-28T00:00:00.000Z,756,5473702,58.86,1383,5151232,55.39,0,0,0,0,0,0,57.89,0,42.11
2021-05-29T00:00:00.000Z,170,5473872,58.86,215,5151447,55.4,0,0,0,0,0,0,57.89,0,42.11
2021-05-30T00:00:00.000Z,1630,5475502,58.88,1921,5153368,55.42,0,0,0,0,0,0,57.92,0,42.08
2021-05-31T00:00:00.000Z,1711,5477213,58.9,2077,5155445,55.44,0,0,0,0,0,0,57.95,0,42.05
2021-06-01T00:00:00.000Z,1351,5478564,58.91,1804,5157249,55.46,0,0,0,0,0,0,57.97,0,42.03
2021-06-02T00:00:00.000Z,1483,5480047,58.93,1590,5158839,55.48,0,0,0,0,0,0,57.99,0,42.01
2021-06-03T00:00:00.000Z,1657,5481704,58.95,1468,5160307,55.49,0,0,0,0,0,0,58.01,0,41.99
2021-06-04T00:00:00.000Z,1068,5482772,58.96,762,5161069,55.5,0,0,0,0,0,0,58.03,0,41.97
2021-06-05T00:00:00.000Z,172,5482944,58.96,148,5161217,55.5,0,0,0,0,0,0,58.03,0,41.97
2021-06-06T00:00:00.000Z,4275,5487219,59.01,988,5162205,55.51,0,0,0,0,0,0,58.07,0,41.93
2021-06-07T00:00:00.000Z,4408,5491627,59.05,789,5162994,55.52,0,0,0,0,0,0,58.1,0,41.9
2021-06-08T00:00:00.000Z,3716,5495343,59.09,1149,5164143,55.53,0,0,0,0,0,0,58.14,0,41.86
2021-06-09T00:00:00.000Z,3571,5498914,59.13,1298,5165441,55.55,0,0,0,0,0,0,58.17,0,41.83
2021-06-10T00:00:00.000Z,3323,5502237,59.17,1273,5166714,55.56,0,0,0,0,0,0,58.2,0,41.8
2021-06-11T00:00:00.000Z,1371,5503608,59.18,564,5167278,55.57,0,0,0,0,0,0,58.21,0,41.79
2021-06-12T00:00:00.000Z,203,5503811,59.19,158,5167436,55.57,0,0,0,0,0,0,58.21,0,41.79
2021-06-13T00:00:00.000Z,3094,5506905,59.22,1244,5168680,55.58,0,0,0,0,0,0,58.24,0,41.76
2021-06-14T00:00:00.000Z,3029,5509934,59.25,1511,5170191,55.6,0,0,0,0,0,0,58.26,0,41.74
2021-06-15T00:00:00.000Z,3119,5513053,59.28,1351,5171542,55.61,0,0,0,0,0,0,58.28,0,41.72
2021-06-16T00:00:00.000Z,2702,5515755,59.31,976,5172518,55.62,0,0,0,0,0,0,58.31,0,41.69
2021-06-17T00:00:00.000Z,2705,5518460,59.34,1176,5173694,55.64,0,0,0,0,0,0,58.33,0,41.67
2021-06-18T00:00:00.000Z,1241,5519701,59.36,477,5174171,55.64,0,0,0,0,0,0,58.34,0,41.66
2021-06-19T00:00:00.000Z,216,5519917,59.36,132,5174303,55.64,0,0,0,0,0,0,58.34,0,41.66
2021-06-20T00:00:00.000Z,3302,5523219,59.39,1315,5175618,55.66,0,0,0,0,0,0,58.37,0,41.63
2021-06-21T00:00:00.000Z,5227,5528446,59.45,1191,5176809,55.67,0,0,0,0,0,0,58.41,0,41.59
2021-06-22T00:00:00.000Z,6901,5535347,59.52,1080,5177889,55.68,0,0,0,0,0,0,58.46,0,41.54
2021-06-23T00:00:00.000Z,10712,5546059,59.64,1272,5179161,55.69,0,0,0,0,0,0,58.54,0,41.46
2021-06-24T00:00:00.000Z,12006,5558065,59.77,1442,5180603,55.71,0,0,0,0,0,0,58.62,0,41.38
2021-06-25T00:00:00.000Z,7080,5565145,59.84,910,5181513,55.72,0,0,0,0,0,0,58.67,0,41.33
2021-06-26T00:00:00.000Z,2257,5567402,59.87,187,5181700,55.72,0,0,0,0,0,0,58.68,0,41.32
2021-06-27T00:00:00.000Z,13607,5581009,60.02,3427,5185127,55.76,0,0,0,0,0,0,58.78,0,41.22
2021-06-28T00:00:00.000Z,14491,5595500,60.17,3652,5188779,55.8,0,0,0,0,0,0,58.88,0,41.12
2021-06-29T00:00:00.000Z,16682,5612182,60.35,3713,5192492,55.84,0,0,0,0,0,0,58.99,0,41.01
2021-06-30T00:00:00.000Z,16455,5628637,60.53,3370,5195862,55.87,0,0,0,0,0,0,59.11,0,40.89
2021-07-01T00:00:00.000Z,16784,5645421,60.71,3347,5199209,55.91,70,70,0,0,0,0,59.23,0,40.77
2021-07-02T00:00:00.000Z,9807,5655228,60.81,1571,5200780,55.93,4,74,0,0,0,0,59.3,0,40.7
2021-07-03T00:00:00.000Z,2657,5657885,60.84,286,5201066,55.93,1,75,0,0,0,0,59.32,0,40.68
2021-07-04T00:00:00.000Z,17715,5675600,61.03,3146,5204212,55.96,1,76,0,0,0,0,59.46,0,40.54
2021-07-05T00:00:00.000Z,17827,5693427,61.22,3018,5207230,56,4,80,0,0,0,0,59.6,0,40.4
2021-07-06T00:00:00.000Z,17816,5711243,61.42,3390,5210620,56.03,10,90,0,0,0,0,59.74,0,40.26
2021-07-07T00:00:00.000Z,15502,5726745,61.58,2667,5213287,56.06,11,101,0,0,0,0,59.87,0,40.13
2021-07-08T00:00:00.000Z,16555,5743300,61.76,2832,5216119,56.09,15,116,0,0,0,0,60,0,40
2021-07-09T00:00:00.000Z,11107,5754407,61.88,1503,5217622,56.11,3,119,0,0,0,0,60.09,0,39.91
2021-07-10T00:00:00.000Z,4961,5759368,61.93,372,5217994,56.11,5,124,0,0,0,0,60.13,0,39.87
2021-07-11T00:00:00.000Z,1446,5760814,61.95,2837,5220831,56.14,5,129,0,0,0,0,60.16,0,39.84
2021-07-12T00:00:00.000Z,2398,5763212,61.97,3667,5224498,56.18,50,179,0,0,0,0,60.2,0,39.8
2021-07-13T00:00:00.000Z,2939,5766151,62.01,5431,5229929,56.24,124,303,0,0,0,0,60.25,0,39.75
2021-07-14T00:00:00.000Z,2715,5768866,62.04,7489,5237418,56.32,440,743,0.01,0,0,0,60.29,0,39.71
2021-07-15T00:00:00.000Z,2968,5771834,62.07,9262,5246680,56.42,373,1116,0.01,0,0,0,60.34,0,39.66
2021-07-16T00:00:00.000Z,1258,5773092,62.08,5863,5252543,56.48,65,1181,0.01,0,0,0,60.36,0,39.64
2021-07-17T00:00:00.000Z,348,5773440,62.08,1376,5253919,56.5,6,1187,0.01,0,0,0,60.37,0,39.63
2021-07-18T00:00:00.000Z,2047,5775487,62.11,9757,5263676,56.6,235,1422,0.02,0,0,0,60.4,0,39.6
2021-07-19T00:00:00.000Z,3181,5778668,62.14,11318,5274994,56.72,457,1879,0.02,0,0,0,60.44,0,39.56
2021-07-20T00:00:00.000Z,2653,5781321,62.17,11883,5286877,56.85,370,2249,0.02,0,0,0,60.42,0.07,39.51
2021-07-21T00:00:00.000Z,2356,5783677,62.19,11850,5298727,56.98,322,2571,0.03,0,0,0,60.26,0.28,39.46
2021-07-22T00:00:00.000Z,2854,5786531,62.23,13228,5311955,57.12,389,2960,0.03,0,0,0,59.93,0.67,39.4
2021-07-23T00:00:00.000Z,2011,5788542,62.25,8198,5320153,57.21,102,3062,0.03,0,0,0,59.35,1.29,39.36
2021-07-24T00:00:00.000Z,615,5789157,62.25,1463,5321616,57.23,6,3068,0.03,0,0,0,58.61,2.04,39.35
2021-07-25T00:00:00.000Z,4406,5793563,62.3,15472,5337088,57.39,223,3291,0.04,0,0,0,58.29,2.43,39.28
2021-07-26T00:00:00.000Z,5146,5798709,62.36,13498,5350586,57.54,322,3613,0.04,0,0,0,58.1,2.71,39.19
2021-07-27T00:00:00.000Z,5461,5804170,62.42,13530,5364116,57.68,412,4025,0.04,0,0,0,57.27,3.63,39.1
2021-07-28T00:00:00.000Z,3964,5808134,62.46,12310,5376426,57.82,469,4494,0.05,0,0,0,56.05,4.93,39.02
2021-07-29T00:00:00.000Z,4634,5812768,62.51,14148,5390574,57.97,527,5021,0.05,0,0,0,54.65,6.41,38.93
2021-07-30T00:00:00.000Z,2632,5815400,62.54,10824,5401398,58.08,4115,9136,0.1,0,0,0,53.18,7.92,38.9
2021-07-31T00:00:00.000Z,1389,5816789,62.55,3533,5404931,58.12,6154,15290,0.16,0,0,0,51.46,9.64,38.9
2021-08-01T00:00:00.000Z,3060,5819849,62.58,3345,5408276,58.16,31041,46331,0.5,0,0,0,50.94,10.15,38.92
2021-08-02T00:00:00.000Z,3108,5822957,62.62,3148,5411424,58.19,58500,104831,1.13,0,0,0,50.72,10.24,39.03
2021-08-03T00:00:00.000Z,3363,5826320,62.65,3294,5414718,58.23,78951,183782,1.98,0,0,0,49.7,11.07,39.23
2021-08-04T00:00:00.000Z,3511,5829831,62.69,3224,5417942,58.26,80747,264529,2.84,0,0,0,48.7,11.86,39.44
2021-08-05T00:00:00.000Z,4488,5834319,62.74,3547,5421489,58.3,88432,352961,3.8,0,0,0,47.92,12.4,39.68
2021-08-06T00:00:00.000Z,2399,5836718,62.77,1822,5423311,58.32,44738,397699,4.28,0,0,0,46.97,13.26,39.77
2021-08-07T00:00:00.000Z,1015,5837733,62.78,661,5423972,58.33,27348,425047,4.57,0,0,0,45.82,14.34,39.84
2021-08-08T00:00:00.000Z,4992,5842725,62.83,3052,5427024,58.36,80067,505114,5.43,0,0,0,45.73,14.27,40
2021-08-09T00:00:00.000Z,5327,5848052,62.89,3027,5430051,58.39,76476,581590,6.25,0,0,0,45.97,13.98,40.05
2021-08-10T00:00:00.000Z,5537,5853589,62.95,3164,5433215,58.43,75411,657001,7.07,0,0,0,46.18,13.81,40.01
2021-08-11T00:00:00.000Z,5676,5859265,63.01,2919,5436134,58.46,62619,719620,7.74,0,0,0,46.57,13.52,39.91
2021-08-12T00:00:00.000Z,7011,5866276,63.08,3267,5439401,58.49,59452,779072,8.38,0,0,0,47.05,13.21,39.74
2021-08-13T00:00:00.000Z,3795,5870071,63.12,2044,5441445,58.51,43854,822926,8.85,0,0,0,47.01,13.29,39.7
2021-08-14T00:00:00.000Z,2246,5872317,63.15,835,5442280,58.52,44468,867394,9.33,0,0,0,46.77,13.49,39.74
2021-08-15T00:00:00.000Z,7157,5879474,63.22,4517,5446797,58.57,97944,965338,10.38,0,0,0,47.43,12.85,39.72
2021-08-16T00:00:00.000Z,6973,5886447,63.3,4723,5451520,58.62,89490,1054828,11.34,0,0,0,48.08,12.25,39.68
2021-08-17T00:00:00.000Z,7573,5894020,63.38,5115,5456635,58.68,83282,1138110,12.24,0,0,0,48.24,12.15,39.61
2021-08-18T00:00:00.000Z,8629,5902649,63.47,4589,5461224,58.73,69232,1207342,12.98,0,0,0,48.3,12.17,39.53
2021-08-19T00:00:00.000Z,10063,5912712,63.58,5193,5466417,58.78,65950,1273292,13.69,0,0,0,48.32,12.24,39.44
2021-08-20T00:00:00.000Z,4733,5917445,63.63,2790,5469207,58.81,60424,1333716,14.34,0,0,0,48.14,12.41,39.44
2021-08-21T00:00:00.000Z,3487,5920932,63.67,1551,5470758,58.83,50706,1384422,14.89,0,0,0,47.9,12.68,39.42
2021-08-22T00:00:00.000Z,9833,5930765,63.78,4783,5475541,58.88,105067,1489489,16.02,0,0,0,48.58,12.09,39.32
2021-08-23T00:00:00.000Z,10927,5941692,63.89,4422,5479963,58.93,93972,1583461,17.03,0,0,0,49.21,11.58,39.21
2021-08-24T00:00:00.000Z,11728,5953420,64.02,4688,5484651,58.98,98479,1681940,18.09,0,0,0,49.46,11.42,39.12
2021-08-25T00:00:00.000Z,9626,5963046,64.12,4457,5489108,59.03,99452,1781392,19.16,0,0,0,49.56,11.37,39.07
2021-08-26T00:00:00.000Z,10106,5973152,64.23,5029,5494137,59.08,101147,1882539,20.24,0,0,0,49.63,11.33,39.04
2021-08-27T00:00:00.000Z,4316,5977468,64.28,2758,5496895,59.11,56659,1939198,20.85,0,0,0,49.51,11.55,38.95
2021-08-28T00:00:00.000Z,3692,5981160,64.32,1475,5498370,59.13,33512,1972710,21.21,0,0,0,49.19,11.98,38.84
2021-08-29T00:00:00.000Z,10342,5991502,64.43,5925,5504295,59.19,79469,2052179,22.07,0,0,0,49.75,11.65,38.61
2021-08-30T00:00:00.000Z,12347,6003849,64.56,6996,5511291,59.27,115935,2168114,23.31,0,0,0,50.44,11.05,38.51
2021-08-31T00:00:00.000Z,12088,6015937,64.69,6495,5517786,59.34,114799,2282913,24.55,0,0,0,50.77,10.82,38.41
2021-09-01T00:00:00.000Z,9056,6024993,64.79,5994,5523780,59.4,112418,2395331,25.76,0,0,0,51.06,10.58,38.36
2021-09-02T00:00:00.000Z,8800,6033793,64.88,7152,5530932,59.48,111455,2506786,26.96,0,0,0,51.47,10.22,38.31
2021-09-03T00:00:00.000Z,3739,6037532,64.92,4087,5535019,59.52,58851,2565637,27.59,0,0,0,51.53,10.2,38.27
2021-09-04T00:00:00.000Z,2692,6040224,64.95,2006,5537025,59.54,29930,2595567,27.91,0,0,0,51.36,10.4,38.23
2021-09-05T00:00:00.000Z,7011,6047235,65.03,6448,5543473,59.61,73277,2668844,28.7,1,1,0,51.84,10.03,38.14
2021-09-06T00:00:00.000Z,2822,6050057,65.06,2674,5546147,59.64,22776,2691620,28.94,0,1,0,52.27,9.9,37.83
2021-09-07T00:00:00.000Z,1186,6051243,65.07,855,5547002,59.65,5381,2697001,29,0,1,0,52.37,10.13,37.5
2021-09-08T00:00:00.000Z,1375,6052618,65.09,1167,5548169,59.66,6608,2703609,29.07,0,1,0,52.44,10.39,37.17
2021-09-09T00:00:00.000Z,7103,6059721,65.16,12539,5560708,59.8,73793,2777402,29.87,0,1,0,52.79,10.21,36.99
2021-09-10T00:00:00.000Z,3245,6062966,65.2,4983,5565691,59.85,37910,2815312,30.27,0,1,0,52.75,10.34,36.91
2021-09-11T00:00:00.000Z,2108,6065074,65.22,2488,5568179,59.88,14801,2830113,30.43,0,1,0,52.38,10.77,36.85
2021-09-12T00:00:00.000Z,6118,6071192,65.29,8580,5576759,59.97,54091,2884204,31.02,0,1,0,52.69,10.57,36.74
2021-09-13T00:00:00.000Z,5624,6076816,65.35,8234,5584993,60.06,47922,2932126,31.53,0,1,0,52.86,10.37,36.76
2021-09-14T00:00:00.000Z,4955,6081771,65.4,7398,5592391,60.14,48818,2980944,32.06,0,1,0,52.63,10.52,36.85
2021-09-15T00:00:00.000Z,1737,6083508,65.42,2691,5595082,60.17,16669,2997613,32.23,0,1,0,52.21,10.93,36.86
2021-09-16T00:00:00.000Z,333,6083841,65.42,534,5595616,60.17,1735,2999348,32.25,0,1,0,51.98,11.42,36.59
2021-09-17T00:00:00.000Z,3674,6087515,65.46,6997,5602613,60.25,42866,3042214,32.71,0,1,0,51.93,11.5,36.57
2021-09-18T00:00:00.000Z,2249,6089764,65.49,2930,5605543,60.28,12777,3054991,32.85,0,1,0,51.53,11.93,36.54
2021-09-19T00:00:00.000Z,5968,6095732,65.55,10701,5616244,60.39,44284,3099275,33.33,0,1,0,51.73,11.82,36.44
2021-09-20T00:00:00.000Z,3240,6098972,65.59,4621,5620865,60.44,16682,3115957,33.51,0,1,0,51.86,11.84,36.3
2021-09-21T00:00:00.000Z,1327,6100299,65.6,2036,5622901,60.47,3465,3119422,33.54,0,1,0,51.53,12.34,36.13
2021-09-22T00:00:00.000Z,4255,6104554,65.65,7227,5630128,60.54,25037,3144459,33.81,0,1,0,51.13,12.74,36.12
2021-09-23T00:00:00.000Z,4396,6108950,65.69,5886,5636014,60.61,27794,3172253,34.11,0,1,0,50.75,13.08,36.17
2021-09-24T00:00:00.000Z,3196,6112146,65.73,4168,5640182,60.65,27696,3199949,34.41,0,1,0,50.65,13.27,36.08
2021-09-25T00:00:00.000Z,2080,6114226,65.75,2243,5642425,60.68,10422,3210371,34.52,0,1,0,50.32,13.63,36.05
2021-09-26T00:00:00.000Z,5621,6119847,65.81,5963,5648388,60.74,36230,3246601,34.91,0,1,0,50.56,13.48,35.95
2021-09-27T00:00:00.000Z,4696,6124543,65.86,4445,5652833,60.79,30423,3277024,35.24,1,2,0,50.72,13.33,35.95
2021-09-28T00:00:00.000Z,1459,6126002,65.88,1163,5653996,60.8,6228,3283252,35.31,0,2,0,50.48,13.59,35.94
2021-09-29T00:00:00.000Z,9642,6135644,65.98,8327,5662323,60.89,60269,3343521,35.95,0,2,0,50.67,13.36,35.97
2021-09-30T00:00:00.000Z,10975,6146619,66.1,8546,5670869,60.98,79652,3423173,36.81,0,2,0,51.24,12.7,36.07
2021-10-01T00:00:00.000Z,5118,6151737,66.15,3847,5674716,61.02,46489,3469662,37.31,0,2,0,51.32,12.6,36.08
2021-10-02T00:00:00.000Z,2863,6154600,66.18,2114,5676830,61.05,22411,3492073,37.55,0,2,0,51.24,12.67,36.09
2021-10-03T00:00:00.000Z,11675,6166275,66.31,7255,5684085,61.12,70685,3562758,38.31,0,2,0,51.81,12.09,36.11
2021-10-04T00:00:00.000Z,10323,6176598,66.42,6738,5690823,61.2,51853,3614611,38.87,0,2,0,52.28,11.63,36.09
2021-10-05T00:00:00.000Z,8452,6185050,66.51,5285,5696108,61.25,40438,3655049,39.3,0,2,0,52.55,11.31,36.15
2021-10-06T00:00:00.000Z,7571,6192621,66.59,4159,5700267,61.3,34068,3689117,39.67,0,2,0,52.9,11.14,35.96
2021-10-07T00:00:00.000Z,6912,6199533,66.67,3984,5704251,61.34,33999,3723116,40.04,0,2,0,53.39,10.91,35.7
2021-10-08T00:00:00.000Z,3086,6202619,66.7,2619,5706870,61.37,19205,3742321,40.24,0,2,0,53.62,10.82,35.56
2021-10-09T00:00:00.000Z,1333,6203952,66.71,1427,5708297,61.38,7423,3749744,40.32,0,2,0,53.66,10.85,35.49
2021-10-10T00:00:00.000Z,4684,6208636,66.76,3733,5712030,61.42,21490,3771234,40.55,0,2,0,54.13,10.63,35.24
2021-10-11T00:00:00.000Z,4296,6212932,66.81,2926,5714956,61.46,17235,3788469,40.74,0,2,0,54.51,10.44,35.05
2021-10-12T00:00:00.000Z,3971,6216903,66.85,2981,5717937,61.49,15333,3803802,40.9,0,2,0,54.66,10.42,34.91
2021-10-13T00:00:00.000Z,3494,6220397,66.89,2434,5720371,61.51,13531,3817333,41.05,0,2,0,54.81,10.41,34.78
2021-10-14T00:00:00.000Z,3871,6224268,66.93,2668,5723039,61.54,16520,3833853,41.23,0,2,0,55,10.34,34.66
2021-10-15T00:00:00.000Z,1695,6225963,66.95,1657,5724696,61.56,8979,3842832,41.32,0,2,0,55.07,10.34,34.59
2021-10-16T00:00:00.000Z,731,6226694,66.96,935,5725631,61.57,4017,3846849,41.37,0,2,0,55.02,10.42,34.56
2021-10-17T00:00:00.000Z,3106,6229800,66.99,2512,5728143,61.6,12762,3859611,41.5,0,2,0,55.21,10.31,34.48
2021-10-18T00:00:00.000Z,2455,6232255,67.02,1657,5729800,61.62,10031,3869642,41.61,0,2,0,55.36,10.23,34.41
2021-10-19T00:00:00.000Z,2384,6234639,67.04,1262,5731062,61.63,9273,3878915,41.71,0,2,0,55.42,10.23,34.35
2021-10-20T00:00:00.000Z,2438,6237077,67.07,2279,5733341,61.65,10052,3888967,41.82,0,2,0,55.49,10.21,34.3
2021-10-21T00:00:00.000Z,3030,6240107,67.1,3071,5736412,61.69,12109,3901076,41.95,0,2,0,55.64,10.12,34.24
2021-10-22T00:00:00.000Z,1274,6241381,67.12,1409,5737821,61.7,5798,3906874,42.01,0,2,0,55.7,10.09,34.21
2021-10-23T00:00:00.000Z,558,6241939,67.12,1252,5739073,61.72,2551,3909425,42.04,0,2,0,55.74,10.07,34.2
2021-10-24T00:00:00.000Z,2510,6244449,67.15,2652,5741725,61.74,9831,3919256,42.15,0,2,0,55.84,10.01,34.15
2021-10-25T00:00:00.000Z,2629,6247078,67.18,2718,5744443,61.77,8469,3927725,42.24,0,2,0,55.95,9.94,34.11
2021-10-26T00:00:00.000Z,2371,6249449,67.2,2030,5746473,61.79,8492,3936217,42.33,0,2,0,56.02,9.9,34.08
2021-10-27T00:00:00.000Z,2297,6251746,67.23,2545,5749018,61.82,7918,3944135,42.41,0,2,0,56.09,9.87,34.04
2021-10-28T00:00:00.000Z,2494,6254240,67.25,2748,5751766,61.85,8633,3952768,42.51,0,2,0,56.17,9.83,33.99
2021-10-29T00:00:00.000Z,885,6255125,67.26,1122,5752888,61.86,4101,3956869,42.55,0,2,0,56.19,9.84,33.98
2021-10-30T00:00:00.000Z,353,6255478,67.27,516,5753404,61.87,1698,3958567,42.57,0,2,0,56.16,9.87,33.96
2021-10-31T00:00:00.000Z,2266,6257744,67.29,2480,5755884,61.9,8226,3966793,42.66,0,2,0,56.26,9.81,33.93
2021-11-01T00:00:00.000Z,1730,6259474,67.31,2079,5757963,61.92,6438,3973231,42.73,0,2,0,56.35,9.76,33.89
2021-11-02T00:00:00.000Z,2025,6261499,67.33,2019,5759982,61.94,6247,3979478,42.79,1,3,0,56.4,9.74,33.86
2021-11-03T00:00:00.000Z,1761,6263260,67.35,1873,5761855,61.96,5514,3984992,42.85,0,3,0,56.43,9.74,33.83
2021-11-04T00:00:00.000Z,2108,6265368,67.37,2782,5764637,61.99,7082,3992074,42.93,0,3,0,56.49,9.72,33.79
2021-11-05T00:00:00.000Z,771,6266139,67.38,881,5765518,62,3431,3995505,42.97,0,3,0,56.48,9.73,33.78
2021-11-06T00:00:00.000Z,340,6266479,67.39,379,5765897,62,1359,3996864,42.98,0,3,0,56.45,9.77,33.77
2021-11-07T00:00:00.000Z,1585,6268064,67.4,1764,5767661,62.02,6112,4002976,43.05,0,3,0,56.53,9.73,33.74
2021-11-08T00:00:00.000Z,1513,6269577,67.42,1576,5769237,62.04,5373,4008349,43.1,0,3,0,56.6,9.68,33.72
2021-11-09T00:00:00.000Z,1425,6271002,67.44,1580,5770817,62.06,5298,4013647,43.16,0,3,0,56.63,9.67,33.7
2021-11-10T00:00:00.000Z,1427,6272429,67.45,1638,5772455,62.07,4731,4018378,43.21,0,3,0,56.66,9.67,33.68
2021-11-11T00:00:00.000Z,1629,6274058,67.47,1920,5774375,62.09,5655,4024033,43.27,3,6,0,56.71,9.64,33.65
2021-11-12T00:00:00.000Z,620,6274678,67.47,805,5775180,62.1,2885,4026918,43.3,0,6,0,56.72,9.64,33.64
2021-11-13T00:00:00.000Z,248,6274926,67.48,279,5775459,62.11,1104,4028022,43.32,0,6,0,56.71,9.66,33.63
2021-11-14T00:00:00.000Z,1544,6276470,67.49,1622,5777081,62.12,5085,4033107,43.37,1,7,0,56.77,9.62,33.61
2021-11-15T00:00:00.000Z,1263,6277733,67.51,1605,5778686,62.14,4741,4037848,43.42,0,7,0,56.83,9.58,33.59
2021-11-16T00:00:00.000Z,1278,6279011,67.52,1390,5780076,62.16,4296,4042144,43.47,0,7,0,56.86,9.57,33.57
2021-11-17T00:00:00.000Z,1212,6280223,67.53,1541,5781617,62.17,3848,4045992,43.51,0,7,0,56.89,9.57,33.55
2021-11-18T00:00:00.000Z,1354,6281577,67.55,1670,5783287,62.19,4968,4050960,43.56,0,7,0,56.93,9.54,33.53
2021-11-19T00:00:00.000Z,585,6282162,67.56,741,5784028,62.2,2413,4053373,43.59,0,7,0,56.94,9.54,33.52
2021-11-20T00:00:00.000Z,234,6282396,67.56,235,5784263,62.2,904,4054277,43.6,1,8,0,56.93,9.56,33.51
2021-11-21T00:00:00.000Z,1424,6283820,67.57,1517,5785780,62.22,4849,4059126,43.65,0,8,0,56.98,9.52,33.5
2021-11-22T00:00:00.000Z,1675,6285495,67.59,1504,5787284,62.23,4190,4063316,43.69,1,9,0,57.04,9.48,33.47
2021-11-23T00:00:00.000Z,8617,6294112,67.68,1663,5788947,62.25,3955,4067271,43.74,0,9,0,57.14,9.46,33.4
2021-11-24T00:00:00.000Z,9354,6303466,67.78,1295,5790242,62.27,3870,4071141,43.78,0,9,0,57.23,9.44,33.33
2021-11-25T00:00:00.000Z,9821,6313287,67.89,1577,5791819,62.28,4795,4075936,43.83,0,9,0,57.31,9.44,33.25
2021-11-26T00:00:00.000Z,5608,6318895,67.95,728,5792547,62.29,2735,4078671,43.86,0,9,0,57.34,9.46,33.21
2021-11-27T00:00:00.000Z,4777,6323672,68,312,5792859,62.29,1135,4079806,43.87,0,9,0,57.35,9.48,33.17
2021-11-28T00:00:00.000Z,10154,6333826,68.11,1474,5794333,62.31,4868,4084674,43.92,0,9,0,57.46,9.45,33.09
2021-11-29T00:00:00.000Z,9038,6342864,68.21,1124,5795457,62.32,4322,4088996,43.97,0,9,0,57.57,9.42,33.01
2021-11-30T00:00:00.000Z,10046,6352910,68.32,1004,5796461,62.33,4033,4093029,44.01,1,10,0,57.65,9.42,32.93
2021-12-01T00:00:00.000Z,8625,6361535,68.41,1080,5797541,62.34,4381,4097410,44.06,2,12,0,57.73,9.42,32.86
2021-12-02T00:00:00.000Z,9171,6370706,68.51,1430,5798971,62.36,5048,4102458,44.12,4,16,0,57.82,9.4,32.78
2021-12-03T00:00:00.000Z,6339,6377045,68.58,653,5799624,62.37,2810,4105268,44.15,1,17,0,57.87,9.4,32.73
2021-12-04T00:00:00.000Z,2505,6379550,68.6,228,5799852,62.37,890,4106158,44.16,1,18,0,57.88,9.41,32.71
2021-12-05T00:00:00.000Z,8336,6387886,68.69,1248,5801100,62.38,4653,4110811,44.21,0,18,0,57.98,9.39,32.63
2021-12-06T00:00:00.000Z,6726,6394612,68.76,1184,5802284,62.39,4297,4115108,44.25,2,20,0,58.07,9.36,32.57
2021-12-07T00:00:00.000Z,5553,6400165,68.82,1489,5803773,62.41,3914,4119022,44.29,3,23,0,58.13,9.35,32.52
2021-12-08T00:00:00.000Z,4931,6405096,68.88,1186,5804959,62.42,3819,4122841,44.34,4,27,0,58.19,9.33,32.48
2021-12-09T00:00:00.000Z,6243,6411339,68.94,1220,5806179,62.44,4456,4127297,44.38,5,32,0,58.27,9.31,32.42
2021-12-10T00:00:00.000Z,3008,6414347,68.98,672,5806851,62.44,2623,4129920,44.41,1,33,0,58.31,9.3,32.39
2021-12-11T00:00:00.000Z,1490,6415837,68.99,248,5807099,62.45,981,4130901,44.42,0,33,0,58.32,9.3,32.38
2021-12-12T00:00:00.000Z,7278,6423115,69.07,1430,5808529,62.46,5213,4136114,44.48,1,34,0,58.42,9.27,32.32
2021-12-13T00:00:00.000Z,6181,6429296,69.14,1356,5809885,62.48,4299,4140413,44.52,1,35,0,58.5,9.24,32.26
2021-12-14T00:00:00.000Z,7327,6436623,69.22,6084,5815969,62.54,4878,4145291,44.58,7,42,0,58.59,9.21,32.2
2021-12-15T00:00:00.000Z,7206,6443829,69.29,7396,5823365,62.62,5391,4150682,44.63,1,43,0,58.68,9.18,32.14
2021-12-16T00:00:00.000Z,8081,6451910,69.38,8602,5831967,62.71,6495,4157177,44.7,5,48,0,58.78,9.15,32.07
2021-12-17T00:00:00.000Z,4390,6456300,69.43,5118,5837085,62.77,3887,4161064,44.75,3,51,0,58.83,9.14,32.04
2021-12-18T00:00:00.000Z,3936,6460236,69.47,2900,5839985,62.8,1320,4162384,44.76,1,52,0,58.86,9.14,32.01
2021-12-19T00:00:00.000Z,6986,6467222,69.55,9326,5849311,62.9,6232,4168616,44.83,2,54,0,58.96,9.1,31.94
2021-12-20T00:00:00.000Z,7982,6475204,69.63,7506,5856817,62.98,5362,4173978,44.88,4,58,0,59.05,9.08,31.87
2021-12-21T00:00:00.000Z,9556,6484760,69.73,8633,5865450,63.07,6409,4180387,44.95,2,60,0,59.18,9.05,31.77
2021-12-22T00:00:00.000Z,9669,6494429,69.84,8132,5873582,63.16,6185,4186572,45.02,7,67,0,59.31,9.03,31.66
2021-12-23T00:00:00.000Z,11548,6505977,69.96,10257,5883839,63.27,8078,4194650,45.11,10,77,0,59.46,9,31.54
2021-12-24T00:00:00.000Z,5886,6511863,70.03,6234,5890073,63.34,5214,4199864,45.16,4,81,0,59.55,8.98,31.47
2021-12-25T00:00:00.000Z,3337,6515200,70.06,2564,5892637,63.37,2015,4201879,45.18,3,84,0,59.59,8.98,31.44
2021-12-26T00:00:00.000Z,10659,6525859,70.18,8911,5901548,63.46,8178,4210057,45.27,5,89,0,59.75,8.93,31.32
2021-12-27T00:00:00.000Z,10373,6536232,70.29,7136,5908684,63.54,8136,4218193,45.36,79,168,0,59.9,8.89,31.21
2021-12-28T00:00:00.000Z,11380,6547612,70.41,7436,5916120,63.62,9581,4227774,45.46,89,257,0,60.05,8.86,31.09
2021-12-29T00:00:00.000Z,9957,6557569,70.52,5957,5922077,63.68,8303,4236077,45.55,9,266,0,60.19,8.83,30.98
2021-12-30T00:00:00.000Z,11020,6568589,70.64,7726,5929803,63.77,12195,4248272,45.68,4,270,0,60.36,8.79,30.86
2021-12-31T00:00:00.000Z,4838,6573427,70.69,3668,5933471,63.81,7256,4255528,45.76,81,351,0,60.44,8.77,30.8
2022-01-01T00:00:00.000Z,1991,6575418,70.71,1588,5935059,63.82,2737,4258265,45.79,34,385,0,60.46,8.76,30.77
2022-01-02T00:00:00.000Z,10226,6585644,70.82,6488,5941547,63.89,12972,4271237,45.93,331,716,0.01,60.63,8.71,30.66
2022-01-03T00:00:00.000Z,9391,6595035,70.92,5244,5946791,63.95,11280,4282517,46.05,12026,12742,0.14,60.78,8.66,30.56
2022-01-04T00:00:00.000Z,8970,6604005,71.02,5940,5952731,64.01,10470,4292987,46.16,50329,63071,0.68,60.91,8.64,30.46
2022-01-05T00:00:00.000Z,8557,6612562,71.11,5726,5958457,64.07,10426,4303413,46.28,59583,122654,1.32,61.03,8.61,30.37
2022-01-06T00:00:00.000Z,10346,6622908,71.22,7958,5966415,64.16,13485,4316898,46.42,63981,186635,2.01,61.18,8.56,30.26
2022-01-07T00:00:00.000Z,4756,6627664,71.27,4543,5970958,64.21,8098,4324996,46.51,31132,217767,2.34,61.25,8.54,30.21
2022-01-08T00:00:00.000Z,2751,6630415,71.3,2444,5973402,64.23,5466,4330462,46.57,27622,245389,2.64,61.28,8.53,30.19
2022-01-09T00:00:00.000Z,9315,6639730,71.4,7728,5981130,64.32,11842,4342304,46.7,66816,312205,3.36,61.43,8.48,30.09
2022-01-10T00:00:00.000Z,8369,6648099,71.49,7647,5988777,64.4,11820,4354124,46.82,64840,377045,4.05,61.57,8.43,30
2022-01-11T00:00:00.000Z,8107,6656206,71.58,8616,5997393,64.49,11924,4366048,46.95,56682,433727,4.66,61.69,8.4,29.91
2022-01-12T00:00:00.000Z,7276,6663482,71.66,8312,6005705,64.58,11065,4377113,47.07,44596,478323,5.14,61.81,8.35,29.83
2022-01-13T00:00:00.000Z,7517,6670999,71.74,9613,6015318,64.69,11492,4388605,47.19,34759,513082,5.52,62,8.27,29.73
2022-01-14T00:00:00.000Z,2556,6673555,71.76,4923,6020241,64.74,6100,4394705,47.26,11161,524243,5.64,62.08,8.23,29.69
2022-01-15T00:00:00.000Z,1463,6675018,71.78,3161,6023402,64.77,3850,4398555,47.3,5713,529956,5.7,62.12,8.21,29.66
2022-01-16T00:00:00.000Z,3821,6678839,71.82,8518,6031920,64.86,7653,4406208,47.38,19998,549954,5.91,62.26,8.14,29.6
2022-01-17T00:00:00.000Z,2809,6681648,71.85,7041,6038961,64.94,6135,4412343,47.45,17833,567787,6.11,62.4,8.06,29.54
2022-01-18T00:00:00.000Z,2476,6684124,71.88,7368,6046329,65.02,5479,4417822,47.51,14845,582632,6.27,62.53,8,29.47
2022-01-19T00:00:00.000Z,1887,6686011,71.9,6358,6052687,65.09,4475,4422297,47.56,8444,591076,6.36,62.7,7.89,29.41
2022-01-20T00:00:00.000Z,1780,6687791,71.92,6956,6059643,65.16,4761,4427058,47.61,8035,599111,6.44,62.8,7.85,29.35
2022-01-21T00:00:00.000Z,900,6688691,71.93,3722,6063365,65.2,2601,4429659,47.63,3350,602461,6.48,62.92,7.77,29.32
2022-01-22T00:00:00.000Z,329,6689020,71.93,1456,6064821,65.22,1042,4430701,47.65,1110,603571,6.49,63,7.71,29.29
2022-01-23T00:00:00.000Z,1064,6690084,71.94,5624,6070445,65.28,2859,4433560,47.68,6082,609653,6.56,63.13,7.63,29.24
2022-01-24T00:00:00.000Z,755,6690839,71.95,4481,6074926,65.33,2236,4435796,47.7,5057,614710,6.61,63.22,7.58,29.2
2022-01-25T00:00:00.000Z,741,6691580,71.96,4395,6079321,65.37,2154,4437950,47.72,7090,621800,6.69,63.28,7.56,29.17
2022-01-26T00:00:00.000Z,614,6692194,71.96,3279,6082600,65.41,1584,4439534,47.74,4258,626058,6.73,63.37,7.5,29.13
2022-01-27T00:00:00.000Z,792,6692986,71.97,4401,6087001,65.46,1970,4441504,47.76,5432,631490,6.79,63.45,7.46,29.09
2022-01-28T00:00:00.000Z,393,6693379,71.98,2370,6089371,65.48,1139,4442643,47.77,3441,634931,6.83,63.49,7.44,29.06
2022-01-29T00:00:00.000Z,124,6693503,71.98,1037,6090408,65.49,403,4443046,47.78,1161,636092,6.84,63.57,7.39,29.05
2022-01-30T00:00:00.000Z,772,6694275,71.99,4713,6095121,65.54,2002,4445048,47.8,8093,644185,6.93,63.66,7.32,29.01
2022-01-31T00:00:00.000Z,528,6694803,71.99,3181,6098302,65.58,1585,4446633,47.82,6461,650646,7,63.84,7.19,28.98
2022-02-01T00:00:00.000Z,475,6695278,72,2776,6101078,65.61,1492,4448125,47.83,5709,656355,7.06,63.87,7.18,28.95
2022-02-02T00:00:00.000Z,374,6695652,72,2382,6103460,65.63,1351,4449476,47.85,5052,661407,7.11,63.88,7.19,28.93
2022-02-03T00:00:00.000Z,443,6696095,72.01,2774,6106234,65.66,1428,4450904,47.86,5596,667003,7.17,63.91,7.18,28.91
2022-02-04T00:00:00.000Z,175,6696270,72.01,985,6107219,65.67,726,4451630,47.87,2445,669448,7.2,63.94,7.17,28.89
2022-02-05T00:00:00.000Z,59,6696329,72.01,337,6107556,65.68,203,4451833,47.87,418,669866,7.2,63.91,7.2,28.89
2022-02-06T00:00:00.000Z,407,6696736,72.01,2315,6109871,65.7,1329,4453162,47.89,5673,675539,7.26,63.98,7.16,28.86
2022-02-07T00:00:00.000Z,279,6697015,72.02,1305,6111176,65.72,952,4454114,47.9,5945,681484,7.33,64.04,7.12,28.84
2022-02-08T00:00:00.000Z,310,6697325,72.02,1495,6112671,65.73,1040,4455154,47.91,6125,687609,7.39,64.09,7.09,28.83
2022-02-09T00:00:00.000Z,243,6697568,72.02,1091,6113762,65.74,917,4456071,47.92,4570,692179,7.44,64.12,7.07,28.81
2022-02-10T00:00:00.000Z,268,6697836,72.03,1289,6115051,65.76,916,4456987,47.93,4810,696989,7.5,64.15,7.05,28.8
2022-02-11T00:00:00.000Z,183,6698019,72.03,535,6115586,65.76,501,4457488,47.93,2525,699514,7.52,64.19,7.02,28.79
2022-02-12T00:00:00.000Z,26,6698045,72.03,89,6115675,65.77,109,4457597,47.93,262,699776,7.53,64.2,7.02,28.79
2022-02-13T00:00:00.000Z,286,6698331,72.03,947,6116622,65.78,958,4458555,47.95,4991,704767,7.58,64.24,6.98,28.78
2022-02-14T00:00:00.000Z,179,6698510,72.03,621,6117243,65.78,734,4459289,47.95,3128,707895,7.61,64.31,6.92,28.77
2022-02-15T00:00:00.000Z,265,6698775,72.04,762,6118005,65.79,908,4460197,47.96,3807,711702,7.65,64.34,6.91,28.76
2022-02-16T00:00:00.000Z,180,6698955,72.04,575,6118580,65.8,783,4460980,47.97,2477,714179,7.68,64.35,6.9,28.75
2022-02-17T00:00:00.000Z,247,6699202,72.04,735,6119315,65.8,754,4461734,47.98,3047,717226,7.71,64.37,6.89,28.74
2022-02-18T00:00:00.000Z,128,6699330,72.04,321,6119636,65.81,422,4462156,47.98,1114,718340,7.72,64.39,6.87,28.74
2022-02-19T00:00:00.000Z,17,6699347,72.04,80,6119716,65.81,70,4462226,47.98,74,718414,7.73,64.39,6.87,28.74
2022-02-20T00:00:00.000Z,204,6699551,72.04,604,6120320,65.81,712,4462938,47.99,2565,720979,7.75,64.42,6.85,28.73
2022-02-21T00:00:00.000Z,168,6699719,72.05,406,6120726,65.82,466,4463404,48,1534,722513,7.77,64.44,6.83,28.72
2022-02-22T00:00:00.000Z,155,6699874,72.05,451,6121177,65.82,553,4463957,48,1860,724373,7.79,64.45,6.83,28.72
2022-02-23T00:00:00.000Z,109,6699983,72.05,350,6121527,65.83,443,4464400,48.01,1148,725521,7.8,64.45,6.84,28.71
2022-02-24T00:00:00.000Z,137,6700120,72.05,452,6121979,65.83,552,4464952,48.01,1485,727006,7.82,64.44,6.85,28.71
2022-02-25T00:00:00.000Z,55,6700175,72.05,137,6122116,65.83,182,4465134,48.02,451,727457,7.82,64.44,6.85,28.71
2022-02-26T00:00:00.000Z,15,6700190,72.05,26,6122142,65.83,147,4465281,48.02,34,727491,7.82,64.43,6.86,28.71
2022-02-27T00:00:00.000Z,109,6700299,72.05,338,6122480,65.84,444,4465725,48.02,1119,728610,7.84,64.44,6.86,28.7
2022-02-28T00:00:00.000Z,109,6700408,72.05,262,6122742,65.84,406,4466131,48.03,901,729511,7.84,64.45,6.85,28.7
2022-03-01T00:00:00.000Z,92,6700500,72.05,277,6123019,65.84,357,4466488,48.03,789,730300,7.85,64.44,6.86,28.7
2022-03-02T00:00:00.000Z,75,6700575,72.05,199,6123218,65.85,315,4466803,48.03,691,730991,7.86,64.43,6.87,28.69
2022-03-03T00:00:00.000Z,148,6700723,72.06,366,6123584,65.85,482,4467285,48.04,986,731977,7.87,64.43,6.88,28.69
2022-03-04T00:00:00.000Z,47,6700770,72.06,128,6123712,65.85,157,4467442,48.04,228,732205,7.87,64.42,6.89,28.69
2022-03-05T00:00:00.000Z,1,6700771,72.06,23,6123735,65.85,39,4467481,48.04,29,732234,7.87,64.41,6.9,28.69
2022-03-06T00:00:00.000Z,93,6700864,72.06,258,6123993,65.85,408,4467889,48.05,760,732994,7.88,64.41,6.91,28.69
2022-03-07T00:00:00.000Z,88,6700952,72.06,255,6124248,65.86,341,4468230,48.05,604,733598,7.89,64.41,6.9,28.68
2022-03-08T00:00:00.000Z,100,6701052,72.06,264,6124512,65.86,328,4468558,48.05,541,734139,7.89,64.4,6.92,28.68
2022-03-09T00:00:00.000Z,85,6701137,72.06,212,6124724,65.86,328,4468886,48.06,488,734627,7.9,64.38,6.94,28.68
2022-03-10T00:00:00.000Z,110,6701247,72.06,363,6125087,65.87,418,4469304,48.06,614,735241,7.91,64.36,6.96,28.68
2022-03-11T00:00:00.000Z,24,6701271,72.06,85,6125172,65.87,113,4469417,48.06,141,735382,7.91,64.35,6.98,28.68
2022-03-12T00:00:00.000Z,6,6701277,72.06,9,6125181,65.87,25,4469442,48.06,24,735406,7.91,64.33,7,28.67
2022-03-13T00:00:00.000Z,92,6701369,72.06,272,6125453,65.87,354,4469796,48.07,589,735995,7.91,64.32,7.01,28.67
2022-03-14T00:00:00.000Z,62,6701431,72.06,249,6125702,65.87,308,4470104,48.07,556,736551,7.92,64.32,7.01,28.67
2022-03-15T00:00:00.000Z,80,6701511,72.06,181,6125883,65.87,279,4470383,48.07,579,737130,7.93,64.3,7.03,28.67
2022-03-16T00:00:00.000Z,73,6701584,72.07,205,6126088,65.88,298,4470681,48.08,665,737795,7.93,64.29,7.04,28.67
2022-03-17T00:00:00.000Z,63,6701647,72.07,120,6126208,65.88,279,4470960,48.08,601,738396,7.94,64.29,7.04,28.67
2022-03-18T00:00:00.000Z,18,6701665,72.07,52,6126260,65.88,96,4471056,48.08,225,738621,7.94,64.29,7.05,28.66
2022-03-19T00:00:00.000Z,5,6701670,72.07,10,6126270,65.88,24,4471080,48.08,35,738656,7.94,64.24,7.1,28.66
2022-03-20T00:00:00.000Z,116,6701786,72.07,254,6126524,65.88,477,4471557,48.08,1426,740082,7.96,64.22,7.12,28.66
2022-03-21T00:00:00.000Z,97,6701883,72.07,241,6126765,65.88,367,4471924,48.09,1119,741201,7.97,64.22,7.12,28.66
2022-03-22T00:00:00.000Z,142,6702025,72.07,340,6127105,65.89,490,4472414,48.09,1764,742965,7.99,64.18,7.16,28.66
2022-03-23T00:00:00.000Z,108,6702133,72.07,209,6127314,65.89,447,4472861,48.1,1668,744633,8.01,64.15,7.19,28.66
2022-03-24T00:00:00.000Z,175,6702308,72.07,339,6127653,65.89,745,4473606,48.11,2350,746983,8.03,64.13,7.21,28.66
2022-03-25T00:00:00.000Z,35,6702343,72.07,75,6127728,65.89,149,4473755,48.11,618,747601,8.04,64.13,7.22,28.66
2022-03-26T00:00:00.000Z,11,6702354,72.07,11,6127739,65.89,31,4473786,48.11,88,747689,8.04,64.12,7.22,28.66
2022-03-27T00:00:00.000Z,157,6702511,72.08,332,6128071,65.9,756,4474542,48.12,3181,750870,8.07,64.11,7.24,28.65
2022-03-28T00:00:00.000Z,114,6702625,72.08,267,6128338,65.9,610,4475152,48.12,2393,753263,8.1,64.1,7.24,28.65
2022-03-29T00:00:00.000Z,129,6702754,72.08,252,6128590,65.9,625,4475777,48.13,2749,756012,8.13,64.06,7.29,28.65
2022-03-30T00:00:00.000Z,47,6702801,72.08,79,6128669,65.9,254,4476031,48.13,1051,757063,8.14,64.04,7.31,28.65
