Day_Date,vaccinated,vaccinated_cum,vaccinated_population_perc,vaccinated_seconde_dose,vaccinated_seconde_dose_cum,vaccinated_seconde_dose_population_perc,vaccinated_third_dose,vaccinated_third_dose_cum,vaccinated_third_dose_population_perc,vaccinated_fourth_dose,vaccinated_fourth_dose_cum,vaccinated_fourth_dose_population_perc,vaccinated_validity_perc,vaccinated_expired_perc,not_vaccinated_perc
2020-12-19T00:00:00.000Z,46,68,0,0,4,0,0,0,0,0,0,0,0,0,100
2020-12-20T00:00:00.000Z,7391,7459,0.08,0,4,0,0,0,0,0,0,0,0,0,100
2020-12-21T00:00:00.000Z,24920,32379,0.35,0,4,0,0,0,0,0,0,0,0,0,100
2020-12-22T00:00:00.000Z,44656,77035,0.83,0,4,0,0,0,0,0,0,0,0,0,100
2020-12-23T00:00:00.000Z,62905,139940,1.5,0,4,0,0,0,0,0,0,0,0,0,100
2020-12-24T00:00:00.000Z,73421,213361,2.29,0,4,0,0,0,0,0,0,0,0,0,100
2020-12-25T00:00:00.000Z,38506,251867,2.71,0,4,0,0,0,0,0,0,0,0,0,100
2020-12-26T00:00:00.000Z,32612,284479,3.06,0,4,0,0,0,0,0,0,0,0,0,100
2020-12-27T00:00:00.000Z,104555,389034,4.18,0,4,0,0,0,0,0,0,0,0,0,100
2020-12-28T00:00:00.000Z,135004,524038,5.64,0,4,0,0,0,0,0,0,0,0,0,100
2020-12-29T00:00:00.000Z,156280,680318,7.32,2,6,0,0,0,0,0,0,0,0,0,100
2020-12-30T00:00:00.000Z,153136,833454,8.96,0,6,0,0,0,0,0,0,0,0,0,100
2020-12-31T00:00:00.000Z,158539,991993,10.67,0,6,0,0,0,0,0,0,0,0,0,100
2021-01-01T00:00:00.000Z,71411,1063404,11.44,0,6,0,0,0,0,0,0,0,0,0,100
2021-01-02T00:00:00.000Z,71720,1135124,12.21,0,6,0,0,0,0,0,0,0,0,0,100
2021-01-03T00:00:00.000Z,149720,1284844,13.82,0,6,0,0,0,0,0,0,0,0,0,100
2021-01-04T00:00:00.000Z,152165,1437009,15.45,1,7,0,0,0,0,0,0,0,0,0,100
2021-01-05T00:00:00.000Z,125169,1562178,16.8,3,10,0,0,0,0,0,0,0,0,0,100
2021-01-06T00:00:00.000Z,103321,1665499,17.91,2,12,0,0,0,0,0,0,0,0,0,100
2021-01-07T00:00:00.000Z,116015,1781514,19.16,9,21,0,0,0,0,0,0,0,0,0,100
2021-01-08T00:00:00.000Z,66436,1847950,19.87,4,25,0,0,0,0,0,0,0,0,0,100
2021-01-09T00:00:00.000Z,44530,1892480,20.35,24,49,0,0,0,0,0,0,0,0,0,100
2021-01-10T00:00:00.000Z,37630,1930110,20.76,5999,6048,0.07,0,0,0,0,0,0,0,0,100
2021-01-11T00:00:00.000Z,21156,1951266,20.98,19262,25310,0.27,0,0,0,0,0,0,0,0,100
2021-01-12T00:00:00.000Z,24057,1975323,21.24,35666,60976,0.66,0,0,0,0,0,0,0,0,100
2021-01-13T00:00:00.000Z,52050,2027373,21.8,56867,117843,1.27,0,0,0,0,0,0,0,0,100
2021-01-14T00:00:00.000Z,56450,2083823,22.41,68831,186674,2.01,0,0,0,0,0,0,0,0,100
2021-01-15T00:00:00.000Z,30754,2114577,22.74,35931,222605,2.39,0,0,0,0,0,0,0,0,100
2021-01-16T00:00:00.000Z,29466,2144043,23.06,26004,248609,2.67,0,0,0,0,0,0,0,0,100
2021-01-17T00:00:00.000Z,68419,2212462,23.79,84587,333196,3.58,0,0,0,0,0,0,0.31,0,99.69
2021-01-18T00:00:00.000Z,69787,2282249,24.54,120413,453609,4.88,0,0,0,0,0,0,0.58,0,99.42
2021-01-19T00:00:00.000Z,72867,2355116,25.33,137812,591421,6.36,0,0,0,0,0,0,1.09,0,98.91
2021-01-20T00:00:00.000Z,76883,2431999,26.15,143736,735157,7.91,0,0,0,0,0,0,1.9,0,98.1
2021-01-21T00:00:00.000Z,69975,2501974,26.91,164419,899576,9.67,0,0,0,0,0,0,2.88,0,97.12
2021-01-22T00:00:00.000Z,37908,2539882,27.31,71117,970693,10.44,0,0,0,0,0,0,3.39,0,96.61
2021-01-23T00:00:00.000Z,39960,2579842,27.74,53571,1024264,11.01,0,0,0,0,0,0,3.77,0,96.23
2021-01-24T00:00:00.000Z,69128,2648970,28.49,140675,1164939,12.53,0,0,0,0,0,0,4.96,0,95.04
2021-01-25T00:00:00.000Z,80928,2729898,29.36,139492,1304431,14.03,0,0,0,0,0,0,6.61,0,93.39
2021-01-26T00:00:00.000Z,78701,2808599,30.2,126399,1430830,15.39,0,0,0,0,0,0,8.45,0,91.55
2021-01-27T00:00:00.000Z,77949,2886548,31.04,125036,1555866,16.73,0,0,0,0,0,0,10.34,0,89.66
2021-01-28T00:00:00.000Z,79549,2966097,31.9,130593,1686459,18.14,0,0,0,0,0,0,12.43,0,87.57
2021-01-29T00:00:00.000Z,36681,3002778,32.29,64775,1751234,18.83,0,0,0,0,0,0,13.34,0,86.66
2021-01-30T00:00:00.000Z,34388,3037166,32.66,42753,1793987,19.29,0,0,0,0,0,0,14.02,0,85.98
2021-01-31T00:00:00.000Z,73315,3110481,33.45,59489,1853476,19.93,0,0,0,0,0,0,15.76,0,84.24
2021-02-01T00:00:00.000Z,82479,3192960,34.34,35338,1888814,20.31,0,0,0,0,0,0,17.48,0,82.52
2021-02-02T00:00:00.000Z,70075,3263035,35.09,31057,1919871,20.65,0,0,0,0,0,0,19.01,0,80.99
2021-02-03T00:00:00.000Z,60283,3323318,35.74,51425,1971296,21.2,0,0,0,0,0,0,20.47,0,79.53
2021-02-04T00:00:00.000Z,72603,3395921,36.52,58077,2029373,21.82,0,0,0,0,0,0,22,0,78
2021-02-05T00:00:00.000Z,33926,3429847,36.88,28791,2058164,22.13,0,0,0,0,0,0,22.75,0,77.25
2021-02-06T00:00:00.000Z,21611,3451458,37.12,22227,2080391,22.37,0,0,0,0,0,0,23.23,0,76.77
2021-02-07T00:00:00.000Z,54069,3505527,37.7,68721,2149112,23.11,0,0,0,0,0,0,23.99,0,76.01
2021-02-08T00:00:00.000Z,58621,3564148,38.33,65447,2214559,23.81,0,0,0,0,0,0,24.52,0,75.48
2021-02-09T00:00:00.000Z,66325,3630473,39.04,67555,2282114,24.54,0,0,0,0,0,0,25.04,0,74.96
2021-02-10T00:00:00.000Z,70548,3701021,39.8,72289,2354403,25.32,0,0,0,0,0,0,25.77,0,74.23
2021-02-11T00:00:00.000Z,81146,3782167,40.67,72090,2426493,26.09,0,0,0,0,0,0,26.61,0,73.39
2021-02-12T00:00:00.000Z,39091,3821258,41.09,37575,2464068,26.5,0,0,0,0,0,0,27.02,0,72.98
2021-02-13T00:00:00.000Z,27457,3848715,41.39,30432,2494500,26.82,0,0,0,0,0,0,27.33,0,72.67
2021-02-14T00:00:00.000Z,74903,3923618,42.19,69072,2563572,27.57,0,0,0,0,0,0,28.25,0,71.75
2021-02-15T00:00:00.000Z,81529,4005147,43.07,75692,2639264,28.38,0,0,0,0,0,0,29.17,0,70.83
2021-02-16T00:00:00.000Z,83406,4088553,43.97,78274,2717538,29.22,0,0,0,0,0,0,30.11,0,69.89
2021-02-17T00:00:00.000Z,61964,4150517,44.63,75616,2793154,30.04,0,0,0,0,0,0,31.01,0,68.99
2021-02-18T00:00:00.000Z,69141,4219658,45.38,79717,2872871,30.89,0,0,0,0,0,0,31.94,0,68.06
2021-02-19T00:00:00.000Z,39659,4259317,45.8,38140,2911011,31.3,0,0,0,0,0,0,32.45,0,67.55
2021-02-20T00:00:00.000Z,31645,4290962,46.14,28721,2939732,31.61,0,0,0,0,0,0,32.85,0,67.15
2021-02-21T00:00:00.000Z,79418,4370380,47,78429,3018161,32.46,0,0,0,0,0,0,33.8,0,66.2
2021-02-22T00:00:00.000Z,85043,4455423,47.91,80579,3098740,33.32,0,0,0,0,0,0,34.83,0,65.17
2021-02-23T00:00:00.000Z,77317,4532740,48.74,70466,3169206,34.08,0,0,0,0,0,0,35.84,0,64.16
2021-02-24T00:00:00.000Z,61055,4593795,49.4,63122,3232328,34.76,0,0,0,0,0,0,36.76,0,63.24
2021-02-25T00:00:00.000Z,51719,4645514,49.96,64787,3297115,35.46,0,0,0,0,0,0,37.66,0,62.34
2021-02-26T00:00:00.000Z,25899,4671413,50.23,32025,3329140,35.8,0,0,0,0,0,0,38.1,0,61.9
2021-02-27T00:00:00.000Z,18342,4689755,50.43,21193,3350333,36.03,0,0,0,0,0,0,38.42,0,61.58
2021-02-28T00:00:00.000Z,40349,4730104,50.87,55862,3406195,36.63,0,0,0,0,0,0,39.24,0,60.76
2021-03-01T00:00:00.000Z,45722,4775826,51.36,61426,3467621,37.29,0,0,0,0,0,0,40.1,0,59.9
2021-03-02T00:00:00.000Z,41181,4817007,51.8,64776,3532397,37.99,0,0,0,0,0,0,40.85,0,59.15
2021-03-03T00:00:00.000Z,42016,4859023,52.25,66765,3599162,38.7,0,0,0,0,0,0,41.55,0,58.45
2021-03-04T00:00:00.000Z,39693,4898716,52.68,79103,3678265,39.55,0,0,0,0,0,0,42.24,0,57.76
2021-03-05T00:00:00.000Z,17349,4916065,52.86,40457,3718722,39.99,0,0,0,0,0,0,42.57,0,57.43
2021-03-06T00:00:00.000Z,10711,4926776,52.98,25342,3744064,40.26,0,0,0,0,0,0,42.78,0,57.22
2021-03-07T00:00:00.000Z,31140,4957916,53.31,72834,3816898,41.05,0,0,0,0,0,0,43.36,0,56.64
2021-03-08T00:00:00.000Z,27369,4985285,53.61,73277,3890175,41.83,0,0,0,0,0,0,43.97,0,56.03
2021-03-09T00:00:00.000Z,26737,5012022,53.9,76587,3966762,42.66,0,0,0,0,0,0,44.62,0,55.38
2021-03-10T00:00:00.000Z,23346,5035368,54.15,58672,4025434,43.29,0,0,0,0,0,0,45.27,0,54.73
2021-03-11T00:00:00.000Z,23294,5058662,54.4,69077,4094511,44.03,0,0,0,0,0,0,45.99,0,54.01
2021-03-12T00:00:00.000Z,11275,5069937,54.52,41403,4135914,44.48,0,0,0,0,0,0,46.34,0,53.66
2021-03-13T00:00:00.000Z,7940,5077877,54.61,25236,4161150,44.75,0,0,0,0,0,0,46.57,0,53.43
2021-03-14T00:00:00.000Z,20973,5098850,54.83,73925,4235075,45.54,0,0,0,0,0,0,47.2,0,52.8
2021-03-15T00:00:00.000Z,20131,5118981,55.05,78264,4313339,46.38,0,0,0,0,0,0,47.81,0,52.19
2021-03-16T00:00:00.000Z,18737,5137718,55.25,71468,4384807,47.15,0,0,0,0,0,0,48.43,0,51.57
2021-03-17T00:00:00.000Z,17687,5155405,55.44,58993,4443800,47.79,0,0,0,0,0,0,48.92,0,51.08
2021-03-18T00:00:00.000Z,16035,5171440,55.61,58121,4501921,48.41,0,0,0,0,0,0,49.45,0,50.55
2021-03-19T00:00:00.000Z,6938,5178378,55.69,27969,4529890,48.71,0,0,0,0,0,0,49.75,0,50.25
2021-03-20T00:00:00.000Z,5216,5183594,55.74,15290,4545180,48.88,0,0,0,0,0,0,49.93,0,50.07
2021-03-21T00:00:00.000Z,13156,5196750,55.88,40497,4585677,49.31,0,0,0,0,0,0,50.46,0,49.54
2021-03-22T00:00:00.000Z,13564,5210314,56.03,40526,4626203,49.75,0,0,0,0,0,0,51,0,49
2021-03-23T00:00:00.000Z,2827,5213141,56.06,7289,4633492,49.83,0,0,0,0,0,0,51.43,0,48.57
2021-03-24T00:00:00.000Z,10987,5224128,56.18,46544,4680036,50.33,0,0,0,0,0,0,51.84,0,48.16
2021-03-25T00:00:00.000Z,10239,5234367,56.29,35416,4715452,50.71,0,0,0,0,0,0,52.22,0,47.78
2021-03-26T00:00:00.000Z,4174,5238541,56.33,13324,4728776,50.85,0,0,0,0,0,0,52.4,0,47.6
2021-03-27T00:00:00.000Z,1778,5240319,56.35,4264,4733040,50.9,0,0,0,0,0,0,52.5,0,47.5
2021-03-28T00:00:00.000Z,2100,5242419,56.37,4601,4737641,50.95,0,0,0,0,0,0,52.74,0,47.26
2021-03-29T00:00:00.000Z,6895,5249314,56.45,30006,4767647,51.27,0,0,0,0,0,0,53,0,47
2021-03-30T00:00:00.000Z,7872,5257186,56.53,22438,4790085,51.51,0,0,0,0,0,0,53.08,0,46.92
2021-03-31T00:00:00.000Z,8136,5265322,56.62,19477,4809562,51.72,0,0,0,0,0,0,53.38,0,46.62
2021-04-01T00:00:00.000Z,8187,5273509,56.71,18685,4828247,51.92,0,0,0,0,0,0,53.62,0,46.38
2021-04-02T00:00:00.000Z,2919,5276428,56.74,8122,4836369,52.01,0,0,0,0,0,0,53.71,0,46.29
2021-04-03T00:00:00.000Z,1423,5277851,56.76,2969,4839338,52.04,0,0,0,0,0,0,53.74,0,46.26
2021-04-04T00:00:00.000Z,9611,5287462,56.86,22824,4862162,52.29,0,0,0,0,0,0,53.82,0,46.18
2021-04-05T00:00:00.000Z,10341,5297803,56.97,21263,4883425,52.51,0,0,0,0,0,0,54.04,0,45.96
2021-04-06T00:00:00.000Z,9008,5306811,57.07,16777,4900202,52.69,0,0,0,0,0,0,54.21,0,45.79
2021-04-07T00:00:00.000Z,8902,5315713,57.16,15294,4915496,52.86,0,0,0,0,0,0,54.36,0,45.64
2021-04-08T00:00:00.000Z,9403,5325116,57.26,16994,4932490,53.04,0,0,0,0,0,0,54.52,0,45.48
2021-04-09T00:00:00.000Z,3589,5328705,57.3,6234,4938724,53.11,0,0,0,0,0,0,54.58,0,45.42
2021-04-10T00:00:00.000Z,1626,5330331,57.32,3512,4942236,53.15,0,0,0,0,0,0,54.61,0,45.39
2021-04-11T00:00:00.000Z,9025,5339356,57.42,14238,4956474,53.3,0,0,0,0,0,0,54.78,0,45.22
2021-04-12T00:00:00.000Z,8924,5348280,57.51,13219,4969693,53.44,0,0,0,0,0,0,54.95,0,45.05
2021-04-13T00:00:00.000Z,5827,5354107,57.58,4940,4974633,53.49,0,0,0,0,0,0,55.08,0,44.92
2021-04-14T00:00:00.000Z,3634,5357741,57.61,5293,4979926,53.55,0,0,0,0,0,0,55.18,0,44.82
2021-04-15T00:00:00.000Z,681,5358422,57.62,566,4980492,53.56,0,0,0,0,0,0,55.27,0,44.73
2021-04-16T00:00:00.000Z,3399,5361821,57.66,6633,4987125,53.63,0,0,0,0,0,0,55.33,0,44.67
2021-04-17T00:00:00.000Z,809,5362630,57.67,1967,4989092,53.65,0,0,0,0,0,0,55.35,0,44.65
2021-04-18T00:00:00.000Z,7089,5369719,57.74,7426,4996518,53.73,0,0,0,0,0,0,55.47,0,44.53
2021-04-19T00:00:00.000Z,6390,5376109,57.81,7107,5003625,53.81,0,0,0,0,0,0,55.58,0,44.42
2021-04-20T00:00:00.000Z,6266,5382375,57.88,6869,5010494,53.88,0,0,0,0,0,0,55.65,0,44.35
2021-04-21T00:00:00.000Z,6364,5388739,57.95,7087,5017581,53.96,0,0,0,0,0,0,55.71,0,44.29
2021-04-22T00:00:00.000Z,5930,5394669,58.01,7673,5025254,54.04,0,0,0,0,0,0,55.75,0,44.25
2021-04-23T00:00:00.000Z,2747,5397416,58.04,3371,5028625,54.08,0,0,0,0,0,0,55.8,0,44.2
2021-04-24T00:00:00.000Z,762,5398178,58.05,1282,5029907,54.09,0,0,0,0,0,0,55.82,0,44.18
2021-04-25T00:00:00.000Z,4823,5403001,58.1,6912,5036819,54.16,0,0,0,0,0,0,55.89,0,44.11
2021-04-26T00:00:00.000Z,5468,5408469,58.16,7875,5044694,54.25,0,0,0,0,0,0,55.96,0,44.04
2021-04-27T00:00:00.000Z,4494,5412963,58.21,6613,5051307,54.32,0,0,0,0,0,0,56.03,0,43.97
2021-04-28T00:00:00.000Z,4476,5417439,58.26,7301,5058608,54.4,0,0,0,0,0,0,56.09,0,43.91
2021-04-29T00:00:00.000Z,4355,5421794,58.3,7272,5065880,54.48,0,0,0,0,0,0,56.16,0,43.84
2021-04-30T00:00:00.000Z,1910,5423704,58.32,3177,5069057,54.51,0,0,0,0,0,0,56.19,0,43.81
2021-05-01T00:00:00.000Z,452,5424156,58.33,890,5069947,54.52,0,0,0,0,0,0,56.2,0,43.8
2021-05-02T00:00:00.000Z,3218,5427374,58.36,6079,5076026,54.59,0,0,0,0,0,0,56.26,0,43.74
2021-05-03T00:00:00.000Z,3535,5430909,58.4,5810,5081836,54.65,0,0,0,0,0,0,56.32,0,43.68
2021-05-04T00:00:00.000Z,3572,5434481,58.44,4714,5086550,54.7,0,0,0,0,0,0,56.38,0,43.62
2021-05-05T00:00:00.000Z,3275,5437756,58.47,4074,5090624,54.74,0,0,0,0,0,0,56.44,0,43.56
2021-05-06T00:00:00.000Z,3629,5441385,58.51,3133,5093757,54.78,0,0,0,0,0,0,56.5,0,43.5
2021-05-07T00:00:00.000Z,1817,5443202,58.53,2491,5096248,54.8,0,0,0,0,0,0,56.52,0,43.48
2021-05-08T00:00:00.000Z,232,5443434,58.54,497,5096745,54.81,0,0,0,0,0,0,56.53,0,43.47
2021-05-09T00:00:00.000Z,2840,5446274,58.57,4744,5101489,54.86,0,0,0,0,0,0,56.58,0,43.42
2021-05-10T00:00:00.000Z,2887,5449161,58.6,4694,5106183,54.91,0,0,0,0,0,0,56.63,0,43.37
2021-05-11T00:00:00.000Z,2614,5451775,58.63,3864,5110047,54.95,0,0,0,0,0,0,56.67,0,43.33
2021-05-12T00:00:00.000Z,2014,5453789,58.65,3325,5113372,54.99,0,0,0,0,0,0,56.7,0,43.3
2021-05-13T00:00:00.000Z,2030,5455819,58.67,3667,5117039,55.03,0,0,0,0,0,0,56.73,0,43.27
2021-05-14T00:00:00.000Z,962,5456781,58.68,1479,5118518,55.04,0,0,0,0,0,0,56.75,0,43.25
2021-05-15T00:00:00.000Z,245,5457026,58.68,252,5118770,55.04,0,0,0,0,0,0,56.75,0,43.25
2021-05-16T00:00:00.000Z,526,5457552,58.69,1200,5119970,55.06,0,0,0,0,0,0,56.78,0,43.22
2021-05-17T00:00:00.000Z,288,5457840,58.69,833,5120803,55.07,0,0,0,0,0,0,56.81,0,43.19
2021-05-18T00:00:00.000Z,1949,5459789,58.71,4924,5125727,55.12,0,0,0,0,0,0,56.84,0,43.16
2021-05-19T00:00:00.000Z,2212,5462001,58.74,5030,5130757,55.17,0,0,0,0,0,0,56.87,0,43.13
2021-05-20T00:00:00.000Z,2302,5464303,58.76,3867,5134624,55.22,0,0,0,0,0,0,56.9,0,43.1
2021-05-21T00:00:00.000Z,1174,5465477,58.77,1392,5136016,55.23,0,0,0,0,0,0,56.92,0,43.08
2021-05-22T00:00:00.000Z,204,5465681,58.78,387,5136403,55.23,0,0,0,0,0,0,56.92,0,43.08
2021-05-23T00:00:00.000Z,2267,5467948,58.8,3212,5139615,55.27,0,0,0,0,0,0,56.94,0,43.06
2021-05-24T00:00:00.000Z,2113,5470061,58.82,3588,5143203,55.31,0,0,0,0,0,0,56.96,0,43.04
2021-05-25T00:00:00.000Z,1810,5471871,58.84,2577,5145780,55.34,0,0,0,0,0,0,56.99,0,43.01
2021-05-26T00:00:00.000Z,1394,5473265,58.86,2491,5148271,55.36,0,0,0,0,0,0,57.03,0,42.97
2021-05-27T00:00:00.000Z,1831,5475096,58.88,3175,5151446,55.4,0,0,0,0,0,0,57.06,0,42.94
2021-05-28T00:00:00.000Z,768,5475864,58.88,1394,5152840,55.41,0,0,0,0,0,0,57.07,0,42.93
2021-05-29T00:00:00.000Z,177,5476041,58.89,222,5153062,55.41,0,0,0,0,0,0,57.07,0,42.93
2021-05-30T00:00:00.000Z,1632,5477673,58.9,1925,5154987,55.43,0,0,0,0,0,0,57.1,0,42.9
2021-05-31T00:00:00.000Z,1718,5479391,58.92,2085,5157072,55.46,0,0,0,0,0,0,57.13,0,42.87
2021-06-01T00:00:00.000Z,1360,5480751,58.94,1813,5158885,55.48,0,0,0,0,0,0,57.47,0,42.53
2021-06-02T00:00:00.000Z,1493,5482244,58.95,1598,5160483,55.49,0,0,0,0,0,0,57.25,0,42.75
2021-06-03T00:00:00.000Z,1667,5483911,58.97,1479,5161962,55.51,0,0,0,0,0,0,57.27,0,42.73
2021-06-04T00:00:00.000Z,1076,5484987,58.98,767,5162729,55.52,0,0,0,0,0,0,57.28,0,42.72
2021-06-05T00:00:00.000Z,178,5485165,58.98,153,5162882,55.52,0,0,0,0,0,0,57.29,0,42.71
2021-06-06T00:00:00.000Z,4277,5489442,59.03,998,5163880,55.53,0,0,0,0,0,0,57.31,0,42.69
2021-06-07T00:00:00.000Z,4420,5493862,59.08,804,5164684,55.54,0,0,0,0,0,0,57.34,0,42.66
2021-06-08T00:00:00.000Z,3727,5497589,59.12,1158,5165842,55.55,0,0,0,0,0,0,57.36,0,42.64
2021-06-09T00:00:00.000Z,3598,5501187,59.16,1309,5167151,55.56,0,0,0,0,0,0,57.4,0,42.6
2021-06-10T00:00:00.000Z,3345,5504532,59.19,1285,5168436,55.58,0,0,0,0,0,0,57.42,0,42.58
2021-06-11T00:00:00.000Z,1378,5505910,59.21,572,5169008,55.58,0,0,0,0,0,0,57.43,0,42.57
2021-06-12T00:00:00.000Z,210,5506120,59.21,165,5169173,55.59,0,0,0,0,0,0,57.43,0,42.57
2021-06-13T00:00:00.000Z,3094,5509214,59.24,1251,5170424,55.6,0,0,0,0,0,0,57.45,0,42.55
2021-06-14T00:00:00.000Z,3043,5512257,59.28,1519,5171943,55.62,0,0,0,0,0,0,57.46,0,42.54
2021-06-15T00:00:00.000Z,3129,5515386,59.31,1360,5173303,55.63,0,0,0,0,0,0,57.48,0,42.52
2021-06-16T00:00:00.000Z,2710,5518096,59.34,986,5174289,55.64,0,0,0,0,0,0,57.49,0,42.51
2021-06-17T00:00:00.000Z,2715,5520811,59.37,1186,5175475,55.65,0,0,0,0,0,0,57.51,0,42.49
2021-06-18T00:00:00.000Z,1253,5522064,59.38,488,5175963,55.66,0,0,0,0,0,0,57.52,0,42.48
2021-06-19T00:00:00.000Z,228,5522292,59.38,135,5176098,55.66,0,0,0,0,0,0,57.52,0,42.48
2021-06-20T00:00:00.000Z,3309,5525601,59.42,1325,5177423,55.68,0,0,0,0,0,0,57.54,0,42.46
2021-06-21T00:00:00.000Z,5232,5530833,59.48,1199,5178622,55.69,0,0,0,0,0,0,57.56,0,42.44
2021-06-22T00:00:00.000Z,6911,5537744,59.55,1089,5179711,55.7,0,0,0,0,0,0,57.58,0,42.42
2021-06-23T00:00:00.000Z,10725,5548469,59.67,1281,5180992,55.71,0,0,0,0,0,0,57.6,0,42.4
2021-06-24T00:00:00.000Z,12021,5560490,59.79,1452,5182444,55.73,0,0,0,0,0,0,57.62,0,42.38
2021-06-25T00:00:00.000Z,7088,5567578,59.87,926,5183370,55.74,0,0,0,0,0,0,57.62,0,42.38
2021-06-26T00:00:00.000Z,2260,5569838,59.9,192,5183562,55.74,0,0,0,0,0,0,57.63,0,42.37
2021-06-27T00:00:00.000Z,13618,5583456,60.04,3431,5186993,55.78,0,0,0,0,0,0,57.65,0,42.35
2021-06-28T00:00:00.000Z,14502,5597958,60.2,3664,5190657,55.82,0,0,0,0,0,0,57.68,0,42.32
2021-06-29T00:00:00.000Z,16693,5614651,60.38,3723,5194380,55.86,0,0,0,0,0,0,57.69,0,42.31
2021-06-30T00:00:00.000Z,16465,5631116,60.55,3382,5197762,55.89,0,0,0,0,0,0,57.72,0,42.28
2021-07-01T00:00:00.000Z,16802,5647918,60.73,3361,5201123,55.93,97,97,0,0,0,0,57.78,0,42.22
2021-07-02T00:00:00.000Z,9820,5657738,60.84,1583,5202706,55.95,6,103,0,0,0,0,57.79,0,42.21
2021-07-03T00:00:00.000Z,2662,5660400,60.87,293,5202999,55.95,1,104,0,0,0,0,57.79,0,42.21
2021-07-04T00:00:00.000Z,17723,5678123,61.06,3152,5206151,55.98,1,105,0,0,0,0,57.85,0,42.15
2021-07-05T00:00:00.000Z,17839,5695962,61.25,3033,5209184,56.02,6,111,0,0,0,0,57.91,0,42.09
2021-07-06T00:00:00.000Z,17827,5713789,61.44,3396,5212580,56.05,11,122,0,0,0,0,57.99,0,42.01
2021-07-07T00:00:00.000Z,15509,5729298,61.61,2684,5215264,56.08,12,134,0,0,0,0,58.05,0,41.95
2021-07-08T00:00:00.000Z,16571,5745869,61.79,2860,5218124,56.11,17,151,0,0,0,0,58.12,0,41.88
2021-07-09T00:00:00.000Z,11113,5756982,61.91,1518,5219642,56.13,3,154,0,0,0,0,58.15,0,41.85
2021-07-10T00:00:00.000Z,4973,5761955,61.96,377,5220019,56.13,5,159,0,0,0,0,58.15,0,41.85
2021-07-11T00:00:00.000Z,1453,5763408,61.98,2842,5222861,56.16,6,165,0,0,0,0,58.22,0,41.78
2021-07-12T00:00:00.000Z,2410,5765818,62,3672,5226533,56.2,52,217,0,0,0,0,58.29,0,41.71
2021-07-13T00:00:00.000Z,2947,5768765,62.03,5443,5231976,56.26,124,341,0,0,0,0,58.36,0,41.64
2021-07-14T00:00:00.000Z,2730,5771495,62.06,7506,5239482,56.34,441,782,0.01,0,0,0,58.42,0,41.58
2021-07-15T00:00:00.000Z,2979,5774474,62.1,9270,5248752,56.44,374,1156,0.01,0,0,0,58.5,0,41.5
2021-07-16T00:00:00.000Z,1270,5775744,62.11,5872,5254624,56.51,65,1221,0.01,0,0,0,58.54,0,41.46
2021-07-17T00:00:00.000Z,359,5776103,62.11,1383,5256007,56.52,7,1228,0.01,0,0,0,58.55,0,41.44
2021-07-18T00:00:00.000Z,2057,5778160,62.14,9764,5265771,56.63,235,1463,0.02,0,0,0,58.6,0,41.4
2021-07-19T00:00:00.000Z,3194,5781354,62.17,11331,5277102,56.75,460,1923,0.02,0,0,0,58.65,0,41.35
2021-07-20T00:00:00.000Z,2667,5784021,62.2,11892,5288994,56.88,371,2294,0.02,0,0,0,58.72,0,41.28
2021-07-21T00:00:00.000Z,2379,5786400,62.22,11858,5300852,57,323,2617,0.03,0,0,0,58.81,0,41.19
2021-07-22T00:00:00.000Z,2858,5789258,62.25,13244,5314096,57.15,391,3008,0.03,0,0,0,58.93,0,41.07
2021-07-23T00:00:00.000Z,2017,5791275,62.28,8220,5322316,57.23,105,3113,0.03,0,0,0,58.99,0,41.01
2021-07-24T00:00:00.000Z,631,5791906,62.28,1470,5323786,57.25,6,3119,0.03,0,0,0,58.99,0,41
2021-07-25T00:00:00.000Z,4410,5796316,62.33,15481,5339267,57.42,223,3342,0.04,0,0,0,59.1,0,40.89
2021-07-26T00:00:00.000Z,5151,5801467,62.39,13511,5352778,57.56,322,3664,0.04,0,0,0,59.24,0,40.75
2021-07-27T00:00:00.000Z,5476,5806943,62.44,13548,5366326,57.71,413,4077,0.04,0,0,0,59.37,0.01,40.62
2021-07-28T00:00:00.000Z,3976,5810919,62.49,12322,5378648,57.84,471,4548,0.05,0,0,0,59.5,0.01,40.49
2021-07-29T00:00:00.000Z,4645,5815564,62.54,14167,5392815,57.99,529,5077,0.05,0,0,0,59.65,0.01,40.33
2021-07-30T00:00:00.000Z,2641,5818205,62.57,10837,5403652,58.11,4119,9196,0.1,0,0,0,59.74,0.02,40.25
2021-07-31T00:00:00.000Z,1396,5819601,62.58,3541,5407193,58.15,6157,15353,0.17,0,0,0,59.75,0.02,40.23
2021-08-01T00:00:00.000Z,3068,5822669,62.61,3352,5410545,58.18,31042,46395,0.5,0,0,0,59.91,0.02,40.06
2021-08-02T00:00:00.000Z,3114,5825783,62.65,3158,5413703,58.22,58503,104898,1.13,0,0,0,60.06,0.03,39.91
2021-08-03T00:00:00.000Z,3376,5829159,62.68,3304,5417007,58.25,78949,183847,1.98,0,0,0,60.21,0.03,39.76
2021-08-04T00:00:00.000Z,3511,5832670,62.72,3242,5420249,58.29,80759,264606,2.85,0,0,0,60.34,0.03,39.63
2021-08-05T00:00:00.000Z,4494,5837164,62.77,3556,5423805,58.32,88437,353043,3.8,0,0,0,60.49,0.04,39.47
2021-08-06T00:00:00.000Z,2413,5839577,62.8,1837,5425642,58.34,44738,397781,4.28,0,0,0,60.6,0.04,39.36
2021-08-07T00:00:00.000Z,1018,5840595,62.81,672,5426314,58.35,27349,425130,4.57,0,0,0,60.63,0.04,39.32
2021-08-08T00:00:00.000Z,4989,5845584,62.86,3065,5429379,58.38,80083,505213,5.43,0,0,0,60.68,0.04,39.28
2021-08-09T00:00:00.000Z,5330,5850914,62.92,3040,5432419,58.42,76481,581694,6.26,0,0,0,60.72,0.04,39.24
2021-08-10T00:00:00.000Z,5539,5856453,62.98,3184,5435603,58.45,75419,657113,7.07,0,0,0,60.75,0.04,39.2
2021-08-11T00:00:00.000Z,5680,5862133,63.04,2932,5438535,58.48,62628,719741,7.74,0,0,0,60.79,0.04,39.17
2021-08-12T00:00:00.000Z,7015,5869148,63.11,3275,5441810,58.52,59456,779197,8.38,0,0,0,60.83,0.04,39.12
2021-08-13T00:00:00.000Z,3799,5872947,63.15,2055,5443865,58.54,43863,823060,8.85,0,0,0,60.84,0.05,39.11
2021-08-14T00:00:00.000Z,2247,5875194,63.18,845,5444710,58.55,44479,867539,9.33,0,0,0,60.85,0.05,39.1
2021-08-15T00:00:00.000Z,7150,5882344,63.26,4521,5449231,58.6,97961,965500,10.38,0,0,0,60.89,0.05,39.06
2021-08-16T00:00:00.000Z,6974,5889318,63.33,4732,5453963,58.65,89508,1055008,11.34,0,0,0,60.92,0.04,39.03
2021-08-17T00:00:00.000Z,7571,5896889,63.41,5121,5459084,58.7,83300,1138308,12.24,0,0,0,60.96,0.04,39
2021-08-18T00:00:00.000Z,8629,5905518,63.51,4598,5463682,58.75,69251,1207559,12.99,0,0,0,60.99,0.04,38.96
2021-08-19T00:00:00.000Z,10069,5915587,63.61,5200,5468882,58.81,65961,1273520,13.69,0,0,0,61.03,0.04,38.92
2021-08-20T00:00:00.000Z,4756,5920343,63.66,2799,5471681,58.84,60436,1333956,14.34,0,0,0,61.05,0.05,38.9
2021-08-21T00:00:00.000Z,3491,5923834,63.7,1568,5473249,58.86,50712,1384668,14.89,0,0,0,61.06,0.05,38.89
2021-08-22T00:00:00.000Z,9829,5933663,63.81,4790,5478039,58.91,105080,1489748,16.02,0,0,0,61.12,0.04,38.84
2021-08-23T00:00:00.000Z,10932,5944595,63.93,4430,5482469,58.96,93991,1583739,17.03,0,0,0,61.17,0.04,38.79
2021-08-24T00:00:00.000Z,11723,5956318,64.05,4694,5487163,59.01,98508,1682247,18.09,0,0,0,61.23,0.04,38.73
2021-08-25T00:00:00.000Z,9613,5965931,64.15,4470,5491633,59.05,99487,1781734,19.16,0,0,0,61.29,0.04,38.67
2021-08-26T00:00:00.000Z,10106,5976037,64.26,5037,5496670,59.11,101171,1882905,20.25,0,0,0,61.36,0.03,38.61
2021-08-27T00:00:00.000Z,4320,5980357,64.31,2774,5499444,59.14,56673,1939578,20.86,0,0,0,61.35,0.04,38.61
2021-08-28T00:00:00.000Z,3693,5984050,64.35,1487,5500931,59.15,33522,1973100,21.22,0,0,0,61.4,0.04,38.57
2021-08-29T00:00:00.000Z,10339,5994389,64.46,5932,5506863,59.22,79489,2052589,22.07,0,0,0,61.46,0.03,38.5
2021-08-30T00:00:00.000Z,12340,6006729,64.59,7005,5513868,59.29,115965,2168554,23.32,0,0,0,61.53,0.03,38.44
2021-08-31T00:00:00.000Z,12080,6018809,64.72,6509,5520377,59.36,114828,2283382,24.55,0,0,0,61.6,0.03,38.37
2021-09-01T00:00:00.000Z,9042,6027851,64.82,6010,5526387,59.43,112446,2395828,25.76,0,0,0,61.43,0.03,38.54
2021-09-02T00:00:00.000Z,8791,6036642,64.92,7163,5533550,59.51,111493,2507321,26.96,0,0,0,61.49,0.03,38.48
2021-09-03T00:00:00.000Z,3745,6040387,64.96,4097,5537647,59.55,58869,2566190,27.6,0,0,0,61.56,0.03,38.42
2021-09-04T00:00:00.000Z,2692,6043079,64.98,2012,5539659,59.57,29935,2596125,27.92,0,0,0,61.59,0.03,38.38
2021-09-05T00:00:00.000Z,7002,6050081,65.06,6451,5546110,59.64,73300,2669425,28.71,0,0,0,61.68,0.03,38.29
2021-09-06T00:00:00.000Z,2823,6052904,65.09,2695,5548805,59.67,22785,2692210,28.95,0,0,0,61.77,0.03,38.2
2021-09-07T00:00:00.000Z,1190,6054094,65.1,867,5549672,59.68,5391,2697601,29.01,0,0,0,61.85,0.03,38.12
2021-09-08T00:00:00.000Z,1373,6055467,65.12,1178,5550850,59.69,6616,2704217,29.08,0,0,0,61.93,0.03,38.05
2021-09-09T00:00:00.000Z,7092,6062559,65.19,12553,5563403,59.83,73821,2778038,29.87,0,0,0,62.02,0.03,37.95
2021-09-10T00:00:00.000Z,3253,6065812,65.23,4992,5568395,59.88,37922,2815960,30.28,0,0,0,62.06,0.03,37.91
2021-09-11T00:00:00.000Z,2105,6067917,65.25,2495,5570890,59.91,14807,2830767,30.44,0,0,0,62.08,0.03,37.89
2021-09-12T00:00:00.000Z,6113,6074030,65.32,8584,5579474,60,54105,2884872,31.02,0,0,0,62.16,0.03,37.81
2021-09-13T00:00:00.000Z,5609,6079639,65.38,8248,5587722,60.09,47953,2932825,31.54,0,0,0,62.15,0.03,37.82
2021-09-14T00:00:00.000Z,4955,6084594,65.43,7410,5595132,60.17,48832,2981657,32.06,0,0,0,62.2,0.03,37.77
2021-09-15T00:00:00.000Z,1741,6086335,65.45,2702,5597834,60.2,16676,2998333,32.24,0,0,0,62.25,0.03,37.72
2021-09-16T00:00:00.000Z,337,6086672,65.45,539,5598373,60.2,1741,3000074,32.26,0,0,0,62.37,0.03,37.6
2021-09-17T00:00:00.000Z,3675,6090347,65.49,7009,5605382,60.28,42883,3042957,32.72,0,0,0,62.42,0.03,37.54
2021-09-18T00:00:00.000Z,2252,6092599,65.52,2934,5608316,60.31,12780,3055737,32.86,0,0,0,62.45,0.03,37.52
2021-09-19T00:00:00.000Z,5945,6098544,65.58,10703,5619019,60.42,44314,3100051,33.34,0,0,0,62.55,0.03,37.42
2021-09-20T00:00:00.000Z,3236,6101780,65.62,4632,5623651,60.47,16691,3116742,33.52,0,0,0,62.63,0.03,37.34
2021-09-21T00:00:00.000Z,1330,6103110,65.63,2044,5625695,60.5,3471,3120213,33.55,0,0,0,62.69,0.03,37.28
2021-09-22T00:00:00.000Z,4251,6107361,65.68,7235,5632930,60.57,25060,3145273,33.82,0,0,0,62.72,0.03,37.25
2021-09-23T00:00:00.000Z,4385,6111746,65.72,5896,5638826,60.64,27819,3173092,34.12,0,0,0,62.75,0.03,37.22
2021-09-24T00:00:00.000Z,3199,6114945,65.76,4177,5643003,60.68,27708,3200800,34.42,0,0,0,62.82,0.03,37.15
2021-09-25T00:00:00.000Z,2073,6117018,65.78,2250,5645253,60.71,10433,3211233,34.53,0,0,0,62.85,0.03,37.12
2021-09-26T00:00:00.000Z,5611,6122629,65.84,5965,5651218,60.77,36250,3247483,34.92,0,0,0,62.96,0.03,37
2021-09-27T00:00:00.000Z,4694,6127323,65.89,4453,5655671,60.82,30437,3277920,35.25,0,0,0,63.02,0.03,36.94
2021-09-28T00:00:00.000Z,1463,6128786,65.91,1173,5656844,60.83,6245,3284165,35.32,0,0,0,63.06,0.04,36.91
2021-09-29T00:00:00.000Z,9624,6138410,66.01,8336,5665180,60.92,60303,3344468,35.96,0,0,0,63.13,0.03,36.84
2021-09-30T00:00:00.000Z,10961,6149371,66.13,8562,5673742,61.01,79683,3424151,36.82,0,0,0,63.18,0.03,36.79
2021-10-01T00:00:00.000Z,5114,6154485,66.18,3862,5677604,61.05,46519,3470670,37.32,0,0,0,63.23,0.03,36.73
2021-10-02T00:00:00.000Z,2861,6157346,66.21,2120,5679724,61.08,22419,3493089,37.56,0,0,0,63.26,0.03,36.71
2021-10-03T00:00:00.000Z,11668,6169014,66.34,7262,5686986,61.16,70713,3563802,38.32,0,0,0,63.35,0.03,36.62
2021-10-04T00:00:00.000Z,10317,6179331,66.45,6743,5693729,61.23,51882,3615684,38.88,0,0,0,63.4,0.03,36.57
2021-10-05T00:00:00.000Z,8448,6187779,66.54,5297,5699026,61.28,40463,3656147,39.32,0,0,0,63.41,0.03,36.55
2021-10-06T00:00:00.000Z,7540,6195319,66.62,4168,5703194,61.33,34114,3690261,39.68,0,0,0,63.52,0.03,36.45
2021-10-07T00:00:00.000Z,6885,6202204,66.7,3994,5707188,61.37,34039,3724300,40.05,0,0,0,63.63,0.03,36.34
2021-10-08T00:00:00.000Z,3086,6205290,66.73,2629,5709817,61.4,19227,3743527,40.26,0,0,0,63.68,0.03,36.29
2021-10-09T00:00:00.000Z,1335,6206625,66.74,1433,5711250,61.42,7432,3750959,40.34,0,0,0,63.71,0.03,36.26
2021-10-10T00:00:00.000Z,4674,6211299,66.79,3739,5714989,61.46,21502,3772461,40.57,0,0,0,63.82,0.04,36.14
2021-10-11T00:00:00.000Z,4291,6215590,66.84,2932,5717921,61.49,17254,3789715,40.75,0,0,0,63.91,0.04,36.05
2021-10-12T00:00:00.000Z,3968,6219558,66.88,2992,5720913,61.52,15346,3805061,40.92,0,0,0,63.99,0.05,35.96
2021-10-13T00:00:00.000Z,3482,6223040,66.92,2440,5723353,61.55,13565,3818626,41.06,0,0,0,64.09,0.05,35.86
2021-10-14T00:00:00.000Z,3864,6226904,66.96,2675,5726028,61.57,16548,3835174,41.24,0,0,0,64.19,0.06,35.75
2021-10-15T00:00:00.000Z,1694,6228598,66.98,1672,5727700,61.59,8994,3844168,41.34,0,0,0,64.23,0.07,35.7
2021-10-16T00:00:00.000Z,728,6229326,66.99,943,5728643,61.6,4029,3848197,41.38,0,0,0,64.25,0.08,35.67
2021-10-17T00:00:00.000Z,3089,6232415,67.02,2517,5731160,61.63,12781,3860978,41.52,0,0,0,64.36,0.09,35.56
2021-10-18T00:00:00.000Z,2454,6234869,67.05,1673,5732833,61.65,10054,3871032,41.63,0,0,0,64.43,0.1,35.47
2021-10-19T00:00:00.000Z,2386,6237255,67.07,1273,5734106,61.66,9279,3880311,41.73,0,0,0,64.49,0.1,35.4
2021-10-20T00:00:00.000Z,2429,6239684,67.1,2286,5736392,61.69,10080,3890391,41.84,0,0,0,64.14,0.52,35.34
2021-10-21T00:00:00.000Z,3025,6242709,67.13,3081,5739473,61.72,12142,3902533,41.97,0,0,0,54.23,10.41,35.36
2021-10-22T00:00:00.000Z,1272,6243981,67.14,1422,5740895,61.73,5812,3908345,42.03,0,0,0,54.36,10.26,35.38
2021-10-23T00:00:00.000Z,562,6244543,67.15,1258,5742153,61.75,2559,3910904,42.06,0,0,0,54.42,10.19,35.39
2021-10-24T00:00:00.000Z,2511,6247054,67.18,2650,5744803,61.78,9844,3920748,42.16,0,0,0,54.22,10.43,35.35
2021-10-25T00:00:00.000Z,2627,6249681,67.21,2733,5747536,61.81,8494,3929242,42.25,0,0,0,54.59,10.22,35.19
2021-10-26T00:00:00.000Z,2371,6252052,67.23,2039,5749575,61.83,8505,3937747,42.34,0,0,0,54.64,10.26,35.1
2021-10-27T00:00:00.000Z,2288,6254340,67.26,2549,5752124,61.86,7939,3945686,42.43,0,0,0,54.58,10.37,35.06
2021-10-28T00:00:00.000Z,2491,6256831,67.28,2759,5754883,61.89,8650,3954336,42.52,0,0,0,54.69,10.76,34.55
2021-10-29T00:00:00.000Z,888,6257719,67.29,1136,5756019,61.9,4114,3958450,42.57,0,0,0,54.73,10.75,34.52
2021-10-30T00:00:00.000Z,357,6258076,67.3,525,5756544,61.9,1703,3960153,42.59,0,0,0,54.68,10.81,34.52
2021-10-31T00:00:00.000Z,2258,6260334,67.32,2488,5759032,61.93,8240,3968393,42.67,0,0,0,54.83,10.7,34.47
2021-11-01T00:00:00.000Z,1735,6262069,67.34,2082,5761114,61.95,6458,3974851,42.74,0,0,0,54.95,10.63,34.42
2021-11-02T00:00:00.000Z,2021,6264090,67.36,2029,5763143,61.97,6270,3981121,42.81,0,0,0,54.89,10.69,34.42
2021-11-03T00:00:00.000Z,1752,6265842,67.38,1879,5765022,61.99,5542,3986663,42.87,0,0,0,54.86,10.75,34.39
2021-11-04T00:00:00.000Z,2101,6267943,67.4,2787,5767809,62.02,7110,3993773,42.95,0,0,0,54.85,10.81,34.33
2021-11-05T00:00:00.000Z,776,6268719,67.41,891,5768700,62.03,3456,3997229,42.98,0,0,0,54.85,10.83,34.32
2021-11-06T00:00:00.000Z,341,6269060,67.41,380,5769080,62.04,1368,3998597,43,0,0,0,54.82,10.86,34.32
2021-11-07T00:00:00.000Z,1581,6270641,67.43,1768,5770848,62.06,6120,4004717,43.06,0,0,0,54.92,10.8,34.28
2021-11-08T00:00:00.000Z,1511,6272152,67.45,1593,5772441,62.07,5391,4010108,43.12,0,0,0,55.01,10.75,34.24
2021-11-09T00:00:00.000Z,1420,6273572,67.46,1596,5774037,62.09,5317,4015425,43.18,0,0,0,55.05,10.74,34.21
2021-11-10T00:00:00.000Z,1420,6274992,67.48,1644,5775681,62.11,4763,4020188,43.23,0,0,0,55.08,10.73,34.19
2021-11-11T00:00:00.000Z,1628,6276620,67.5,1931,5777612,62.13,5684,4025872,43.29,0,0,0,55.15,10.69,34.15
2021-11-12T00:00:00.000Z,623,6277243,67.5,814,5778426,62.14,2900,4028772,43.32,0,0,0,55.17,10.69,34.14
2021-11-13T00:00:00.000Z,252,6277495,67.51,282,5778708,62.14,1116,4029888,43.34,0,0,0,55.14,10.72,34.14
2021-11-14T00:00:00.000Z,1536,6279031,67.52,1626,5780334,62.16,5105,4034993,43.39,0,0,0,55.21,10.68,34.11
2021-11-15T00:00:00.000Z,1266,6280297,67.54,1608,5781942,62.18,4757,4039750,43.44,0,0,0,55.28,10.63,34.09
2021-11-16T00:00:00.000Z,1268,6281565,67.55,1397,5783339,62.19,4330,4044080,43.49,0,0,0,55.32,10.62,34.07
2021-11-17T00:00:00.000Z,1194,6282759,67.56,1550,5784889,62.21,3889,4047969,43.53,0,0,0,55.35,10.6,34.05
2021-11-18T00:00:00.000Z,1358,6284117,67.58,1677,5786566,62.23,4989,4052958,43.58,0,0,0,55.41,10.58,34.02
2021-11-19T00:00:00.000Z,584,6284701,67.58,747,5787313,62.23,2437,4055395,43.61,0,0,0,55.42,10.57,34.01
2021-11-20T00:00:00.000Z,234,6284935,67.59,244,5787557,62.24,917,4056312,43.62,0,0,0,55.41,10.58,34
2021-11-21T00:00:00.000Z,1411,6286346,67.6,1527,5789084,62.25,4863,4061175,43.67,0,0,0,55.47,10.54,33.98
2021-11-22T00:00:00.000Z,1675,6288021,67.62,1511,5790595,62.27,4212,4065387,43.72,0,0,0,55.54,10.5,33.96
2021-11-23T00:00:00.000Z,8614,6296635,67.71,1668,5792263,62.29,3983,4069370,43.76,0,0,0,55.57,10.48,33.95
2021-11-24T00:00:00.000Z,9346,6305981,67.81,1307,5793570,62.3,3904,4073274,43.8,0,0,0,55.6,10.44,33.95
2021-11-25T00:00:00.000Z,9809,6315790,67.92,1590,5795160,62.32,4821,4078095,43.85,0,0,0,55.64,10.43,33.93
2021-11-26T00:00:00.000Z,5606,6321396,67.98,736,5795896,62.33,2763,4080858,43.88,0,0,0,55.63,10.45,33.92
2021-11-27T00:00:00.000Z,4777,6326173,68.03,316,5796212,62.33,1148,4082006,43.9,0,0,0,55.62,10.46,33.92
2021-11-28T00:00:00.000Z,10145,6336318,68.14,1479,5797691,62.35,4886,4086892,43.95,0,0,0,55.67,10.43,33.9
2021-11-29T00:00:00.000Z,9038,6345356,68.23,1126,5798817,62.36,4350,4091242,44,0,0,0,55.73,10.39,33.88
2021-11-30T00:00:00.000Z,10042,6355398,68.34,1018,5799835,62.37,4058,4095300,44.04,0,0,0,55.77,10.37,33.86
2021-12-01T00:00:00.000Z,8622,6364020,68.44,1087,5800922,62.38,4417,4099717,44.09,2,2,0,55.79,10.36,33.84
2021-12-02T00:00:00.000Z,9170,6373190,68.53,1434,5802356,62.4,5092,4104809,44.14,6,8,0,55.84,10.34,33.82
2021-12-03T00:00:00.000Z,6333,6379523,68.6,659,5803015,62.4,2844,4107653,44.17,1,9,0,55.86,10.33,33.81
2021-12-04T00:00:00.000Z,2506,6382029,68.63,232,5803247,62.41,906,4108559,44.18,2,11,0,55.85,10.34,33.81
2021-12-05T00:00:00.000Z,8335,6390364,68.72,1250,5804497,62.42,4666,4113225,44.23,0,11,0,55.9,10.31,33.79
2021-12-06T00:00:00.000Z,6722,6397086,68.79,1186,5805683,62.43,4324,4117549,44.28,4,15,0,55.95,10.27,33.78
2021-12-07T00:00:00.000Z,5548,6402634,68.85,1489,5807172,62.45,3948,4121497,44.32,6,21,0,55.99,10.25,33.76
2021-12-08T00:00:00.000Z,4930,6407564,68.9,1188,5808360,62.46,3849,4125346,44.36,8,29,0,56.03,10.22,33.75
2021-12-09T00:00:00.000Z,6238,6413802,68.97,1223,5809583,62.47,4484,4129830,44.41,7,36,0,56.08,10.19,33.73
2021-12-10T00:00:00.000Z,3006,6416808,69,685,5810268,62.48,2652,4132482,44.44,3,39,0,56.1,10.18,33.72
2021-12-11T00:00:00.000Z,1491,6418299,69.02,251,5810519,62.48,1002,4133484,44.45,0,39,0,56.1,10.18,33.71
2021-12-12T00:00:00.000Z,7271,6425570,69.1,1436,5811955,62.5,5234,4138718,44.51,2,41,0,56.16,10.15,33.69
2021-12-13T00:00:00.000Z,6176,6431746,69.16,1364,5813319,62.51,4328,4143046,44.55,3,44,0,56.21,10.11,33.67
2021-12-14T00:00:00.000Z,7318,6439064,69.24,6095,5819414,62.58,4916,4147962,44.61,10,54,0,56.27,10.09,33.65
2021-12-15T00:00:00.000Z,7202,6446266,69.32,7398,5826812,62.66,5416,4153378,44.66,2,56,0,56.34,10.06,33.6
2021-12-16T00:00:00.000Z,8081,6454347,69.41,8603,5835415,62.75,6531,4159909,44.73,6,62,0,56.53,10.05,33.42
2021-12-17T00:00:00.000Z,4398,6458745,69.45,5121,5840536,62.81,3917,4163826,44.78,3,65,0,56.64,10.05,33.3
2021-12-18T00:00:00.000Z,3938,6462683,69.5,2907,5843443,62.84,1341,4165167,44.79,2,67,0,56.73,10.07,33.2
2021-12-19T00:00:00.000Z,6983,6469666,69.57,9328,5852771,62.94,6252,4171419,44.86,4,71,0,56.92,10.04,33.04
2021-12-20T00:00:00.000Z,7970,6477636,69.66,7508,5860279,63.02,5407,4176826,44.92,8,79,0,57.07,10.02,32.91
2021-12-21T00:00:00.000Z,9547,6487183,69.76,8642,5868921,63.11,6443,4183269,44.98,5,84,0,57.27,10.01,32.71
2021-12-22T00:00:00.000Z,9665,6496848,69.86,8138,5877059,63.2,6214,4189483,45.05,10,94,0,57.49,10,32.52
2021-12-23T00:00:00.000Z,11542,6508390,69.99,10258,5887317,63.31,8109,4197592,45.14,13,107,0,57.7,9.97,32.33
2021-12-24T00:00:00.000Z,5878,6514268,70.05,6237,5893554,63.38,5244,4202836,45.2,8,115,0,57.83,9.96,32.21
2021-12-25T00:00:00.000Z,3338,6517606,70.09,2565,5896119,63.4,2016,4204852,45.22,5,120,0,57.9,9.96,32.15
2021-12-26T00:00:00.000Z,10653,6528259,70.2,8909,5905028,63.5,8186,4213038,45.3,8,128,0,58.1,9.92,31.98
2021-12-27T00:00:00.000Z,10368,6538627,70.31,7137,5912165,63.58,8165,4221203,45.39,18,146,0,58.27,9.9,31.83
2021-12-28T00:00:00.000Z,11374,6550001,70.44,7440,5919605,63.66,9614,4230817,45.5,16,162,0,58.46,9.88,31.66
2021-12-29T00:00:00.000Z,9939,6559940,70.54,5958,5925563,63.72,8339,4239156,45.59,15,177,0,58.64,9.85,31.51
2021-12-30T00:00:00.000Z,11015,6570955,70.66,7726,5933289,63.8,12222,4251378,45.72,7,184,0,58.84,9.82,31.34
2021-12-31T00:00:00.000Z,4833,6575788,70.71,3669,5936958,63.84,7280,4258658,45.8,132,316,0,58.9,9.79,31.3
2022-01-01T00:00:00.000Z,1991,6577779,70.73,1590,5938548,63.86,2740,4261398,45.82,60,376,0,58.93,9.79,31.28
2022-01-02T00:00:00.000Z,10217,6587996,70.84,6484,5945032,63.93,12995,4274393,45.96,588,964,0.01,59.14,9.76,31.1
2022-01-03T00:00:00.000Z,9386,6597382,70.95,5253,5950285,63.99,11308,4285701,46.09,25052,26016,0.28,59.29,9.71,31
2022-01-04T00:00:00.000Z,8969,6606351,71.04,5940,5956225,64.05,10498,4296199,46.2,50643,76659,0.82,59.46,9.68,30.86
2022-01-05T00:00:00.000Z,8552,6614903,71.13,5735,5961960,64.11,10463,4306662,46.31,59563,136222,1.46,59.56,9.65,30.79
2022-01-06T00:00:00.000Z,10341,6625244,71.24,7960,5969920,64.2,13515,4320177,46.46,63973,200195,2.15,59.81,9.63,30.56
2022-01-07T00:00:00.000Z,4753,6629997,71.3,4550,5974470,64.25,8124,4328301,46.54,31128,231323,2.49,59.89,9.61,30.49
2022-01-08T00:00:00.000Z,2750,6632747,71.33,2451,5976921,64.27,5486,4333787,46.6,27623,258946,2.78,59.9,9.64,30.46
2022-01-09T00:00:00.000Z,9312,6642059,71.43,7725,5984646,64.36,11853,4345640,46.73,66749,325695,3.5,60.06,9.59,30.35
2022-01-10T00:00:00.000Z,8360,6650419,71.52,7651,5992297,64.44,11846,4357486,46.86,64742,390437,4.2,60.21,9.54,30.25
2022-01-11T00:00:00.000Z,8106,6658525,71.6,8618,6000915,64.53,11950,4369436,46.99,56635,447072,4.81,60.38,9.49,30.13
2022-01-12T00:00:00.000Z,7280,6665805,71.68,8311,6009226,64.62,11087,4380523,47.11,44598,491670,5.29,60.51,9.45,30.04
2022-01-13T00:00:00.000Z,7514,6673319,71.76,9618,6018844,64.72,11516,4392039,47.23,34736,526406,5.66,60.7,9.35,29.94
2022-01-14T00:00:00.000Z,2555,6675874,71.79,4931,6023775,64.78,6126,4398165,47.3,11136,537542,5.78,60.79,9.31,29.9
2022-01-15T00:00:00.000Z,1462,6677336,71.8,3163,6026938,64.81,3865,4402030,47.34,5714,543256,5.84,60.83,9.29,29.87
2022-01-16T00:00:00.000Z,3818,6681154,71.85,8520,6035458,64.9,7668,4409698,47.42,19982,563238,6.06,60.97,9.2,29.82
2022-01-17T00:00:00.000Z,2809,6683963,71.88,7043,6042501,64.98,6150,4415848,47.49,17830,581068,6.25,61.09,9.13,29.78
2022-01-18T00:00:00.000Z,2473,6686436,71.9,7376,6049877,65.06,5504,4421352,47.55,14807,595875,6.41,61.23,9.07,29.7
2022-01-19T00:00:00.000Z,1915,6688351,71.92,6361,6056238,65.13,4499,4425851,47.59,8451,604326,6.5,61.37,8.98,29.65
2022-01-20T00:00:00.000Z,1779,6690130,71.94,6962,6063200,65.2,4772,4430623,47.64,8036,612362,6.59,61.44,8.85,29.71
2022-01-21T00:00:00.000Z,900,6691030,71.95,3727,6066927,65.24,2622,4433245,47.67,3353,615715,6.62,61.51,8.81,29.68
2022-01-22T00:00:00.000Z,328,6691358,71.96,1457,6068384,65.26,1048,4434293,47.68,1112,616827,6.63,61.51,8.75,29.74
2022-01-23T00:00:00.000Z,1067,6692425,71.97,5624,6074008,65.32,2869,4437162,47.72,6078,622905,6.7,61.61,8.7,29.69
2022-01-24T00:00:00.000Z,757,6693182,71.98,4480,6078488,65.37,2247,4439409,47.74,5050,627955,6.75,61.73,8.62,29.65
2022-01-25T00:00:00.000Z,741,6693923,71.98,4396,6082884,65.41,2163,4441572,47.76,7101,635056,6.83,61.9,8.51,29.59
2022-01-26T00:00:00.000Z,613,6694536,71.99,3283,6086167,65.45,1598,4443170,47.78,4259,639315,6.87,62.02,8.42,29.57
2022-01-27T00:00:00.000Z,792,6695328,72,4403,6090570,65.5,1983,4445153,47.8,5435,644750,6.93,62.12,8.35,29.52
2022-01-28T00:00:00.000Z,394,6695722,72,2373,6092943,65.52,1156,4446309,47.81,3444,648194,6.97,62.16,8.33,29.5
2022-01-29T00:00:00.000Z,124,6695846,72,1042,6093985,65.53,416,4446725,47.82,1158,649352,6.98,62.23,8.29,29.48
2022-01-30T00:00:00.000Z,768,6696614,72.01,4715,6098700,65.58,2011,4448736,47.84,8098,657450,7.07,62.3,8.24,29.46
2022-01-31T00:00:00.000Z,528,6697142,72.02,3183,6101883,65.62,1596,4450332,47.86,6467,663917,7.14,62.39,8.17,29.43
2022-02-01T00:00:00.000Z,477,6697619,72.02,2797,6104680,65.65,1507,4451839,47.87,5717,669634,7.2,62.45,8.15,29.4
2022-02-02T00:00:00.000Z,374,6697993,72.03,2383,6107063,65.67,1366,4453205,47.89,5069,674703,7.26,62.28,8.13,29.59
2022-02-03T00:00:00.000Z,444,6698437,72.03,2774,6109837,65.7,1446,4454651,47.9,5601,680304,7.32,62.34,8.08,29.57
2022-02-04T00:00:00.000Z,174,6698611,72.03,985,6110822,65.71,744,4455395,47.91,2449,682753,7.34,62.37,8.06,29.57
2022-02-05T00:00:00.000Z,60,6698671,72.03,339,6111161,65.72,207,4455602,47.91,418,683171,7.35,62.34,8.09,29.56
2022-02-06T00:00:00.000Z,406,6699077,72.04,2317,6113478,65.74,1335,4456937,47.93,5677,688848,7.41,62.41,8.05,29.55
2022-02-07T00:00:00.000Z,281,6699358,72.04,1307,6114785,65.76,968,4457905,47.94,5956,694804,7.47,62.47,8.01,29.52
2022-02-08T00:00:00.000Z,313,6699671,72.05,1493,6116278,65.77,1051,4458956,47.95,6132,700936,7.54,62.54,7.97,29.49
2022-02-09T00:00:00.000Z,252,6699923,72.05,1101,6117379,65.78,932,4459888,47.96,4570,705506,7.59,62.6,7.95,29.45
2022-02-10T00:00:00.000Z,270,6700193,72.05,1291,6118670,65.8,925,4460813,47.97,4812,710318,7.64,62.63,7.93,29.44
2022-02-11T00:00:00.000Z,199,6700392,72.05,543,6119213,65.8,504,4461317,47.97,2530,712848,7.67,62.67,7.91,29.42
2022-02-12T00:00:00.000Z,27,6700419,72.05,90,6119303,65.8,118,4461435,47.98,263,713111,7.67,62.67,7.91,29.41
2022-02-13T00:00:00.000Z,286,6700705,72.06,945,6120248,65.81,962,4462397,47.99,4994,718105,7.72,62.73,7.87,29.39
2022-02-14T00:00:00.000Z,179,6700884,72.06,622,6120870,65.82,743,4463140,47.99,3136,721241,7.76,62.89,7.74,29.36
2022-02-15T00:00:00.000Z,266,6701150,72.06,762,6121632,65.83,922,4464062,48,3814,725055,7.8,62.92,7.73,29.35
2022-02-16T00:00:00.000Z,179,6701329,72.06,576,6122208,65.84,796,4464858,48.01,2484,727539,7.82,62.95,7.72,29.34
2022-02-17T00:00:00.000Z,248,6701577,72.07,737,6122945,65.84,765,4465623,48.02,3051,730590,7.86,62.96,7.7,29.34
2022-02-18T00:00:00.000Z,126,6701703,72.07,328,6123273,65.85,426,4466049,48.03,1113,731703,7.87,62.98,7.69,29.33
2022-02-19T00:00:00.000Z,33,6701736,72.07,82,6123355,65.85,73,4466122,48.03,77,731780,7.87,62.99,7.69,29.32
2022-02-20T00:00:00.000Z,202,6701938,72.07,604,6123959,65.85,714,4466836,48.03,2566,734346,7.9,63.01,7.67,29.32
2022-02-21T00:00:00.000Z,173,6702111,72.07,411,6124370,65.86,481,4467317,48.04,1540,735886,7.91,63.04,7.65,29.31
2022-02-22T00:00:00.000Z,155,6702266,72.07,452,6124822,65.86,556,4467873,48.05,1866,737752,7.93,63.05,7.65,29.3
2022-02-23T00:00:00.000Z,109,6702375,72.07,351,6125173,65.87,451,4468324,48.05,1152,738904,7.95,63.06,7.65,29.29
2022-02-24T00:00:00.000Z,137,6702512,72.08,454,6125627,65.87,560,4468884,48.06,1490,740394,7.96,63.05,7.66,29.29
2022-02-25T00:00:00.000Z,58,6702570,72.08,137,6125764,65.87,186,4469070,48.06,454,740848,7.97,63.06,7.66,29.28
2022-02-26T00:00:00.000Z,15,6702585,72.08,26,6125790,65.87,150,4469220,48.06,34,740882,7.97,63.05,7.67,29.28
2022-02-27T00:00:00.000Z,113,6702698,72.08,339,6126129,65.88,447,4469667,48.06,1118,742000,7.98,63.05,7.67,29.28
2022-02-28T00:00:00.000Z,108,6702806,72.08,265,6126394,65.88,411,4470078,48.07,903,742903,7.99,63.07,7.65,29.28
2022-03-01T00:00:00.000Z,97,6702903,72.08,278,6126672,65.88,363,4470441,48.07,794,743697,8,63.1,7.63,29.27
2022-03-02T00:00:00.000Z,74,6702977,72.08,200,6126872,65.89,319,4470760,48.08,692,744389,8,63.11,7.62,29.27
2022-03-03T00:00:00.000Z,155,6703132,72.08,368,6127240,65.89,494,4471254,48.08,983,745372,8.02,63.05,7.67,29.27
2022-03-04T00:00:00.000Z,52,6703184,72.08,163,6127403,65.89,163,4471417,48.08,226,745598,8.02,63.05,7.68,29.27
2022-03-05T00:00:00.000Z,1,6703185,72.08,24,6127427,65.89,43,4471460,48.08,30,745628,8.02,63.04,7.69,29.27
2022-03-06T00:00:00.000Z,98,6703283,72.08,259,6127686,65.89,412,4471872,48.09,759,746387,8.03,63.04,7.69,29.27
2022-03-07T00:00:00.000Z,88,6703371,72.08,255,6127941,65.9,345,4472217,48.09,603,746990,8.03,63.05,7.69,29.26
2022-03-08T00:00:00.000Z,98,6703469,72.09,263,6128204,65.9,330,4472547,48.1,548,747538,8.04,63.04,7.7,29.26
2022-03-09T00:00:00.000Z,88,6703557,72.09,212,6128416,65.9,333,4472880,48.1,490,748028,8.04,63.02,7.72,29.25
2022-03-10T00:00:00.000Z,113,6703670,72.09,372,6128788,65.91,420,4473300,48.1,615,748643,8.05,63.01,7.74,29.25
2022-03-11T00:00:00.000Z,24,6703694,72.09,85,6128873,65.91,116,4473416,48.1,142,748785,8.05,63,7.75,29.25
2022-03-12T00:00:00.000Z,9,6703703,72.09,10,6128883,65.91,28,4473444,48.11,27,748812,8.05,62.98,7.77,29.24
2022-03-13T00:00:00.000Z,94,6703797,72.09,270,6129153,65.91,356,4473800,48.11,594,749406,8.06,62.98,7.78,29.24
2022-03-14T00:00:00.000Z,64,6703861,72.09,250,6129403,65.91,316,4474116,48.11,559,749965,8.06,62.98,7.78,29.24
2022-03-15T00:00:00.000Z,78,6703939,72.09,182,6129585,65.91,288,4474404,48.12,583,750548,8.07,62.95,7.81,29.24
2022-03-16T00:00:00.000Z,74,6704013,72.09,205,6129790,65.92,300,4474704,48.12,669,751217,8.08,62.94,7.82,29.24
2022-03-17T00:00:00.000Z,65,6704078,72.09,119,6129909,65.92,284,4474988,48.12,607,751824,8.08,62.94,7.82,29.24
2022-03-18T00:00:00.000Z,18,6704096,72.09,53,6129962,65.92,99,4475087,48.12,229,752053,8.09,62.94,7.82,29.24
2022-03-19T00:00:00.000Z,5,6704101,72.09,10,6129972,65.92,26,4475113,48.12,37,752090,8.09,62.89,7.88,29.23
2022-03-20T00:00:00.000Z,119,6704220,72.09,258,6130230,65.92,481,4475594,48.13,1426,753516,8.1,62.87,7.89,29.23
2022-03-21T00:00:00.000Z,97,6704317,72.09,243,6130473,65.92,373,4475967,48.13,1129,754645,8.12,62.87,7.9,29.23
2022-03-22T00:00:00.000Z,140,6704457,72.1,339,6130812,65.93,502,4476469,48.14,1767,756412,8.13,62.84,7.94,29.23
2022-03-23T00:00:00.000Z,108,6704565,72.1,209,6131021,65.93,458,4476927,48.14,1673,758085,8.15,62.81,7.97,29.22
2022-03-24T00:00:00.000Z,175,6704740,72.1,344,6131365,65.93,762,4477689,48.15,2359,760444,8.18,62.78,8,29.22
2022-03-25T00:00:00.000Z,35,6704775,72.1,78,6131443,65.93,154,4477843,48.15,626,761070,8.18,62.78,8,29.23
2022-03-26T00:00:00.000Z,12,6704787,72.1,11,6131454,65.93,32,4477875,48.15,89,761159,8.19,62.77,8,29.22
2022-03-27T00:00:00.000Z,162,6704949,72.1,344,6131798,65.94,758,4478633,48.16,3187,764346,8.22,62.75,8.02,29.22
2022-03-28T00:00:00.000Z,115,6705064,72.1,268,6132066,65.94,617,4479250,48.17,2399,766745,8.25,62.75,8.03,29.22
2022-03-29T00:00:00.000Z,125,6705189,72.1,259,6132325,65.94,634,4479884,48.17,2764,769509,8.27,62.7,8.07,29.22
2022-03-30T00:00:00.000Z,132,6705321,72.11,209,6132534,65.95,537,4480421,48.18,2364,771873,8.3,62.81,8.11,29.07
2022-03-31T00:00:00.000Z,166,6705487,72.11,293,6132827,65.95,728,4481149,48.19,2838,774711,8.33,62.79,8.11,29.1
2022-04-01T00:00:00.000Z,118,6705605,72.11,158,6132985,65.95,275,4481424,48.19,579,775290,8.34,62.72,8.13,29.15
2022-04-02T00:00:00.000Z,6,6705611,72.11,5,6132990,65.95,34,4481458,48.19,50,775340,8.34,62.69,8.15,29.16
2022-04-03T00:00:00.000Z,157,6705768,72.11,267,6133257,65.95,566,4482024,48.2,2472,777812,8.36,62.65,8.16,29.19
2022-04-04T00:00:00.000Z,104,6705872,72.11,204,6133461,65.96,479,4482503,48.2,2212,780024,8.39,62.62,8.16,29.22
2022-04-05T00:00:00.000Z,122,6705994,72.11,218,6133679,65.96,513,4483016,48.21,2233,782257,8.41,62.57,8.19,29.25
2022-04-06T00:00:00.000Z,91,6706085,72.11,154,6133833,65.96,380,4483396,48.21,2011,784268,8.43,62.55,8.2,29.25
2022-04-07T00:00:00.000Z,180,6706265,72.12,210,6134043,65.96,634,4484030,48.22,2550,786818,8.46,62.56,8.2,29.24
2022-04-08T00:00:00.000Z,28,6706293,72.12,55,6134098,65.96,149,4484179,48.22,469,787287,8.47,62.54,8.22,29.23
2022-04-09T00:00:00.000Z,6,6706299,72.12,16,6134114,65.96,24,4484203,48.22,42,787329,8.47,62.52,8.25,29.23
2022-04-10T00:00:00.000Z,101,6706400,72.12,258,6134372,65.97,425,4484628,48.23,1841,789170,8.49,62.51,8.26,29.23
2022-04-11T00:00:00.000Z,78,6706478,72.12,200,6134572,65.97,370,4484998,48.23,1419,790589,8.5,62.54,8.26,29.2
2022-04-12T00:00:00.000Z,202,6706680,72.12,164,6134736,65.97,370,4485368,48.23,1357,791946,8.52,62.58,8.29,29.12
2022-04-13T00:00:00.000Z,117,6706797,72.12,148,6134884,65.97,298,4485666,48.24,1215,793161,8.53,62.58,8.31,29.1
2022-04-14T00:00:00.000Z,82,6706879,72.12,223,6135107,65.97,318,4485984,48.24,1065,794226,8.54,62.57,8.33,29.1
2022-04-15T00:00:00.000Z,9,6706888,72.12,51,6135158,65.97,47,4486031,48.24,79,794305,8.54,62.55,8.35,29.1
2022-04-16T00:00:00.000Z,3,6706891,72.12,8,6135166,65.97,20,4486051,48.24,26,794331,8.54,62.53,8.37,29.1
2022-04-17T00:00:00.000Z,61,6706952,72.12,130,6135296,65.98,228,4486279,48.24,807,795138,8.55,62.52,8.38,29.1
2022-04-18T00:00:00.000Z,68,6707020,72.12,108,6135404,65.98,249,4486528,48.25,747,795885,8.56,62.51,8.38,29.1
2022-04-19T00:00:00.000Z,61,6707081,72.12,131,6135535,65.98,270,4486798,48.25,828,796713,8.57,62.5,8.4,29.1
2022-04-20T00:00:00.000Z,63,6707144,72.13,118,6135653,65.98,231,4487029,48.25,642,797355,8.57,62.48,8.42,29.1
2022-04-21T00:00:00.000Z,53,6707197,72.13,107,6135760,65.98,189,4487218,48.25,477,797832,8.58,62.47,8.43,29.1
2022-04-22T00:00:00.000Z,0,6707197,72.13,15,6135775,65.98,15,4487233,48.25,14,797846,8.58,62.45,8.44,29.11
2022-04-23T00:00:00.000Z,4,6707201,72.13,8,6135783,65.98,13,4487246,48.25,13,797859,8.58,62.43,8.46,29.11
2022-04-24T00:00:00.000Z,93,6707294,72.13,247,6136030,65.98,326,4487572,48.26,861,798720,8.59,62.43,8.47,29.1
2022-04-25T00:00:00.000Z,105,6707399,72.13,191,6136221,65.99,310,4487882,48.26,736,799456,8.6,62.43,8.47,29.1
2022-04-26T00:00:00.000Z,74,6707473,72.13,173,6136394,65.99,298,4488180,48.26,779,800235,8.61,62.42,8.48,29.1
2022-04-27T00:00:00.000Z,55,6707528,72.13,160,6136554,65.99,222,4488402,48.27,636,800871,8.61,62.41,8.49,29.1
2022-04-28T00:00:00.000Z,95,6707623,72.13,220,6136774,65.99,326,4488728,48.27,858,801729,8.62,62.41,8.5,29.1
2022-04-29T00:00:00.000Z,108,6707731,72.13,142,6136916,65.99,183,4488911,48.27,204,801933,8.62,62.39,8.51,29.1
2022-04-30T00:00:00.000Z,1,6707732,72.13,2,6136918,65.99,23,4488934,48.27,19,801952,8.62,62.38,8.52,29.1
2022-05-01T00:00:00.000Z,120,6707852,72.13,184,6137102,66,312,4489246,48.28,629,802581,8.63,62.38,8.53,29.09
2022-05-02T00:00:00.000Z,61,6707913,72.13,151,6137253,66,235,4489481,48.28,485,803066,8.64,62.37,8.54,29.09
2022-05-03T00:00:00.000Z,72,6707985,72.13,150,6137403,66,284,4489765,48.28,498,803564,8.64,62.36,8.55,29.09
2022-05-04T00:00:00.000Z,24,6708009,72.13,55,6137458,66,57,4489822,48.28,122,803686,8.64,62.35,8.57,29.08
2022-05-05T00:00:00.000Z,0,6708009,72.13,0,6137458,66,2,4489824,48.28,3,803689,8.64,62.34,8.58,29.08
2022-05-06T00:00:00.000Z,18,6708027,72.13,59,6137517,66,63,4489887,48.28,143,803832,8.64,62.33,8.59,29.08
2022-05-07T00:00:00.000Z,0,6708027,72.13,5,6137522,66,25,4489912,48.28,22,803854,8.64,62.32,8.6,29.08
2022-05-08T00:00:00.000Z,92,6708119,72.14,201,6137723,66,270,4490182,48.29,454,804308,8.65,62.31,8.61,29.08
2022-05-09T00:00:00.000Z,59,6708178,72.14,150,6137873,66,236,4490418,48.29,490,804798,8.65,62.31,8.61,29.08
2022-05-10T00:00:00.000Z,128,6708306,72.14,165,6138038,66.01,259,4490677,48.29,503,805301,8.66,62.3,8.62,29.08
2022-05-11T00:00:00.000Z,58,6708364,72.14,116,6138154,66.01,178,4490855,48.29,462,805763,8.66,62.3,8.63,29.08
2022-05-12T00:00:00.000Z,117,6708481,72.14,201,6138355,66.01,273,4491128,48.3,659,806422,8.67,62.29,8.64,29.07
2022-05-13T00:00:00.000Z,11,6708492,72.14,39,6138394,66.01,70,4491198,48.3,106,806528,8.67,62.28,8.65,29.07
2022-05-14T00:00:00.000Z,6,6708498,72.14,10,6138404,66.01,9,4491207,48.3,22,806550,8.67,62.26,8.66,29.07
2022-05-15T00:00:00.000Z,90,6708588,72.14,170,6138574,66.01,237,4491444,48.3,656,807206,8.68,62.26,8.67,29.07
2022-05-16T00:00:00.000Z,68,6708656,72.14,129,6138703,66.01,214,4491658,48.3,498,807704,8.69,62.19,8.65,29.16
2022-05-17T00:00:00.000Z,75,6708731,72.14,150,6138853,66.01,257,4491915,48.3,606,808310,8.69,62.18,8.66,29.16
2022-05-18T00:00:00.000Z,45,6708776,72.14,95,6138948,66.02,167,4492082,48.31,442,808752,8.7,62.17,8.67,29.16
2022-05-19T00:00:00.000Z,62,6708838,72.14,170,6139118,66.02,207,4492289,48.31,495,809247,8.7,62.16,8.68,29.16
2022-05-20T00:00:00.000Z,63,6708901,72.14,96,6139214,66.02,122,4492411,48.31,137,809384,8.7,62.15,8.69,29.16
2022-05-21T00:00:00.000Z,4,6708905,72.14,6,6139220,66.02,12,4492423,48.31,13,809397,8.7,62.14,8.7,29.16
2022-05-22T00:00:00.000Z,79,6708984,72.15,186,6139406,66.02,211,4492634,48.31,422,809819,8.71,62.14,8.71,29.16
2022-05-23T00:00:00.000Z,0,6708984,72.15,0,6139406,66.02,0,4492634,48.31,0,809819,8.71,62.14,8.71,29.16
