Day_Date,vaccinated,vaccinated_cum,vaccinated_population_perc,vaccinated_seconde_dose,vaccinated_seconde_dose_cum,vaccinated_seconde_dose_population_perc,vaccinated_third_dose,vaccinated_third_dose_cum,vaccinated_third_dose_population_perc,vaccinated_fourth_dose,vaccinated_fourth_dose_cum,vaccinated_fourth_dose_population_perc,vaccinated_validity_perc,vaccinated_expired_perc,not_vaccinated_perc
2020-12-19T00:00:00.000Z,46,70,0,0,4,0,0,0,0,0,0,0,0,0,100
2020-12-20T00:00:00.000Z,7393,7463,0.08,0,4,0,0,0,0,0,0,0,0,0,100
2020-12-21T00:00:00.000Z,24922,32385,0.35,0,4,0,0,0,0,0,0,0,0,0,100
2020-12-22T00:00:00.000Z,44662,77047,0.83,0,4,0,0,0,0,0,0,0,0,0,100
2020-12-23T00:00:00.000Z,62914,139961,1.51,0,4,0,0,0,0,0,0,0,0,0,100
2020-12-24T00:00:00.000Z,73423,213384,2.29,0,4,0,0,0,0,0,0,0,0,0,100
2020-12-25T00:00:00.000Z,38512,251896,2.71,0,4,0,0,0,0,0,0,0,0,0,100
2020-12-26T00:00:00.000Z,32617,284513,3.06,0,4,0,0,0,0,0,0,0,0,0,100
2020-12-27T00:00:00.000Z,104562,389075,4.18,0,4,0,0,0,0,0,0,0,0,0,100
2020-12-28T00:00:00.000Z,135016,524091,5.64,0,4,0,0,0,0,0,0,0,0,0,100
2020-12-29T00:00:00.000Z,156308,680399,7.32,2,6,0,0,0,0,0,0,0,0,0,100
2020-12-30T00:00:00.000Z,153159,833558,8.96,0,6,0,0,0,0,0,0,0,0,0,100
2020-12-31T00:00:00.000Z,158562,992120,10.67,0,6,0,0,0,0,0,0,0,0,0,100
2021-01-01T00:00:00.000Z,71424,1063544,11.44,0,6,0,0,0,0,0,0,0,0,0,100
2021-01-02T00:00:00.000Z,71734,1135278,12.21,0,6,0,0,0,0,0,0,0,0,0,100
2021-01-03T00:00:00.000Z,149750,1285028,13.82,0,6,0,0,0,0,0,0,0,0,0,100
2021-01-04T00:00:00.000Z,152180,1437208,15.46,1,7,0,0,0,0,0,0,0,0,0,100
2021-01-05T00:00:00.000Z,125193,1562401,16.8,4,11,0,0,0,0,0,0,0,0,0,100
2021-01-06T00:00:00.000Z,103352,1665753,17.91,2,13,0,0,0,0,0,0,0,0,0,100
2021-01-07T00:00:00.000Z,116037,1781790,19.16,9,22,0,0,0,0,0,0,0,0,0,100
2021-01-08T00:00:00.000Z,66450,1848240,19.88,4,26,0,0,0,0,0,0,0,0,0,100
2021-01-09T00:00:00.000Z,44542,1892782,20.35,24,50,0,0,0,0,0,0,0,0,0,100
2021-01-10T00:00:00.000Z,37642,1930424,20.76,5999,6049,0.07,0,0,0,0,0,0,0,0,100
2021-01-11T00:00:00.000Z,21165,1951589,20.99,19263,25312,0.27,0,0,0,0,0,0,0,0,100
2021-01-12T00:00:00.000Z,24067,1975656,21.25,35671,60983,0.66,0,0,0,0,0,0,0,0,100
2021-01-13T00:00:00.000Z,52064,2027720,21.81,56872,117855,1.27,0,0,0,0,0,0,0,0,100
2021-01-14T00:00:00.000Z,56468,2084188,22.41,68833,186688,2.01,0,0,0,0,0,0,0,0,100
2021-01-15T00:00:00.000Z,30767,2114955,22.74,35938,222626,2.39,0,0,0,0,0,0,0,0,100
2021-01-16T00:00:00.000Z,29477,2144432,23.06,26006,248632,2.67,0,0,0,0,0,0,0,0,100
2021-01-17T00:00:00.000Z,68429,2212861,23.8,84590,333222,3.58,0,0,0,0,0,0,0.31,0,99.69
2021-01-18T00:00:00.000Z,69809,2282670,24.55,120422,453644,4.88,0,0,0,0,0,0,0.58,0,99.42
2021-01-19T00:00:00.000Z,72884,2355554,25.33,137829,591473,6.36,0,0,0,0,0,0,1.09,0,98.91
2021-01-20T00:00:00.000Z,76899,2432453,26.16,143752,735225,7.91,0,0,0,0,0,0,1.9,0,98.1
2021-01-21T00:00:00.000Z,69990,2502443,26.91,164444,899669,9.67,0,0,0,0,0,0,2.88,0,97.12
2021-01-22T00:00:00.000Z,37917,2540360,27.32,71127,970796,10.44,0,0,0,0,0,0,3.39,0,96.61
2021-01-23T00:00:00.000Z,39962,2580322,27.75,53583,1024379,11.02,0,0,0,0,0,0,3.77,0,96.23
2021-01-24T00:00:00.000Z,69139,2649461,28.49,140694,1165073,12.53,0,0,0,0,0,0,4.96,0,95.04
2021-01-25T00:00:00.000Z,80935,2730396,29.36,139503,1304576,14.03,0,0,0,0,0,0,6.61,0,93.39
2021-01-26T00:00:00.000Z,78716,2809112,30.21,126426,1431002,15.39,0,0,0,0,0,0,8.45,0,91.55
2021-01-27T00:00:00.000Z,77966,2887078,31.05,125054,1556056,16.73,0,0,0,0,0,0,10.34,0,89.66
2021-01-28T00:00:00.000Z,79563,2966641,31.9,130608,1686664,18.14,0,0,0,0,0,0,12.43,0,87.57
2021-01-29T00:00:00.000Z,36696,3003337,32.3,64784,1751448,18.83,0,0,0,0,0,0,13.34,0,86.66
2021-01-30T00:00:00.000Z,34392,3037729,32.67,42759,1794207,19.29,0,0,0,0,0,0,14.02,0,85.98
2021-01-31T00:00:00.000Z,73325,3111054,33.45,59494,1853701,19.93,0,0,0,0,0,0,15.76,0,84.24
2021-02-01T00:00:00.000Z,82495,3193549,34.34,35348,1889049,20.31,0,0,0,0,0,0,17.48,0,82.52
2021-02-02T00:00:00.000Z,70089,3263638,35.1,31062,1920111,20.65,0,0,0,0,0,0,19.01,0,80.99
2021-02-03T00:00:00.000Z,60303,3323941,35.74,51434,1971545,21.2,0,0,0,0,0,0,20.47,0,79.53
2021-02-04T00:00:00.000Z,72621,3396562,36.52,58087,2029632,21.83,0,0,0,0,0,0,22,0,78
2021-02-05T00:00:00.000Z,33940,3430502,36.89,28800,2058432,22.14,0,0,0,0,0,0,22.75,0,77.25
2021-02-06T00:00:00.000Z,21618,3452120,37.12,22228,2080660,22.37,0,0,0,0,0,0,23.23,0,76.77
2021-02-07T00:00:00.000Z,54075,3506195,37.7,68728,2149388,23.11,0,0,0,0,0,0,23.99,0,76.01
2021-02-08T00:00:00.000Z,58631,3564826,38.33,65458,2214846,23.82,0,0,0,0,0,0,24.52,0,75.48
2021-02-09T00:00:00.000Z,66342,3631168,39.05,67566,2282412,24.54,0,0,0,0,0,0,25.04,0,74.96
2021-02-10T00:00:00.000Z,70559,3701727,39.81,72302,2354714,25.32,0,0,0,0,0,0,25.77,0,74.23
2021-02-11T00:00:00.000Z,81155,3782882,40.68,72097,2426811,26.1,0,0,0,0,0,0,26.61,0,73.39
2021-02-12T00:00:00.000Z,39094,3821976,41.1,37587,2464398,26.5,0,0,0,0,0,0,27.02,0,72.98
2021-02-13T00:00:00.000Z,27458,3849434,41.39,30440,2494838,26.83,0,0,0,0,0,0,27.33,0,72.67
2021-02-14T00:00:00.000Z,74910,3924344,42.2,69077,2563915,27.57,0,0,0,0,0,0,28.25,0,71.75
2021-02-15T00:00:00.000Z,81538,4005882,43.08,75714,2639629,28.39,0,0,0,0,0,0,29.17,0,70.83
2021-02-16T00:00:00.000Z,83412,4089294,43.97,78286,2717915,29.23,0,0,0,0,0,0,30.11,0,69.89
2021-02-17T00:00:00.000Z,61976,4151270,44.64,75633,2793548,30.04,0,0,0,0,0,0,31.01,0,68.99
2021-02-18T00:00:00.000Z,69147,4220417,45.38,79728,2873276,30.9,0,0,0,0,0,0,31.94,0,68.06
2021-02-19T00:00:00.000Z,39666,4260083,45.81,38153,2911429,31.31,0,0,0,0,0,0,32.45,0,67.55
2021-02-20T00:00:00.000Z,31648,4291731,46.15,28723,2940152,31.62,0,0,0,0,0,0,32.85,0,67.15
2021-02-21T00:00:00.000Z,79428,4371159,47.01,78441,3018593,32.46,0,0,0,0,0,0,33.8,0,66.2
2021-02-22T00:00:00.000Z,85054,4456213,47.92,80587,3099180,33.33,0,0,0,0,0,0,34.83,0,65.17
2021-02-23T00:00:00.000Z,77320,4533533,48.75,70473,3169653,34.08,0,0,0,0,0,0,35.84,0,64.16
2021-02-24T00:00:00.000Z,61064,4594597,49.41,63136,3232789,34.76,0,0,0,0,0,0,36.76,0,63.24
2021-02-25T00:00:00.000Z,51724,4646321,49.96,64799,3297588,35.46,0,0,0,0,0,0,37.66,0,62.34
2021-02-26T00:00:00.000Z,25906,4672227,50.24,32038,3329626,35.81,0,0,0,0,0,0,38.1,0,61.9
2021-02-27T00:00:00.000Z,18347,4690574,50.44,21195,3350821,36.03,0,0,0,0,0,0,38.42,0,61.58
2021-02-28T00:00:00.000Z,40357,4730931,50.87,55869,3406690,36.63,0,0,0,0,0,0,39.24,0,60.76
2021-03-01T00:00:00.000Z,45738,4776669,51.37,61433,3468123,37.29,0,0,0,0,0,0,40.1,0,59.9
2021-03-02T00:00:00.000Z,41195,4817864,51.81,64791,3532914,37.99,0,0,0,0,0,0,40.85,0,59.15
2021-03-03T00:00:00.000Z,42020,4859884,52.26,66785,3599699,38.71,0,0,0,0,0,0,41.55,0,58.45
2021-03-04T00:00:00.000Z,39708,4899592,52.69,79112,3678811,39.56,0,0,0,0,0,0,42.24,0,57.76
2021-03-05T00:00:00.000Z,17358,4916950,52.87,40460,3719271,40,0,0,0,0,0,0,42.57,0,57.43
2021-03-06T00:00:00.000Z,10718,4927668,52.99,25342,3744613,40.27,0,0,0,0,0,0,42.78,0,57.22
2021-03-07T00:00:00.000Z,31152,4958820,53.32,72838,3817451,41.05,0,0,0,0,0,0,43.36,0,56.64
2021-03-08T00:00:00.000Z,27381,4986201,53.62,73290,3890741,41.84,0,0,0,0,0,0,43.97,0,56.03
2021-03-09T00:00:00.000Z,26749,5012950,53.91,76595,3967336,42.66,0,0,0,0,0,0,44.62,0,55.38
2021-03-10T00:00:00.000Z,23362,5036312,54.16,58678,4026014,43.29,0,0,0,0,0,0,45.27,0,54.73
2021-03-11T00:00:00.000Z,23295,5059607,54.41,69084,4095098,44.04,0,0,0,0,0,0,45.99,0,54.01
2021-03-12T00:00:00.000Z,11291,5070898,54.53,41408,4136506,44.48,0,0,0,0,0,0,46.34,0,53.66
2021-03-13T00:00:00.000Z,7944,5078842,54.62,25237,4161743,44.75,0,0,0,0,0,0,46.57,0,53.43
2021-03-14T00:00:00.000Z,20982,5099824,54.84,73930,4235673,45.55,0,0,0,0,0,0,47.2,0,52.8
2021-03-15T00:00:00.000Z,20138,5119962,55.06,78276,4313949,46.39,0,0,0,0,0,0,47.81,0,52.19
2021-03-16T00:00:00.000Z,18749,5138711,55.26,71473,4385422,47.16,0,0,0,0,0,0,48.43,0,51.57
2021-03-17T00:00:00.000Z,17698,5156409,55.45,59000,4444422,47.79,0,0,0,0,0,0,48.92,0,51.08
2021-03-18T00:00:00.000Z,16043,5172452,55.62,58125,4502547,48.42,0,0,0,0,0,0,49.45,0,50.55
2021-03-19T00:00:00.000Z,6948,5179400,55.7,27974,4530521,48.72,0,0,0,0,0,0,49.75,0,50.25
2021-03-20T00:00:00.000Z,5223,5184623,55.75,15297,4545818,48.88,0,0,0,0,0,0,49.93,0,50.07
2021-03-21T00:00:00.000Z,13167,5197790,55.89,40503,4586321,49.32,0,0,0,0,0,0,50.46,0,49.54
2021-03-22T00:00:00.000Z,13571,5211361,56.04,40534,4626855,49.75,0,0,0,0,0,0,51,0,49
2021-03-23T00:00:00.000Z,2838,5214199,56.07,7297,4634152,49.83,0,0,0,0,0,0,51.43,0,48.57
2021-03-24T00:00:00.000Z,10989,5225188,56.19,46551,4680703,50.33,0,0,0,0,0,0,51.84,0,48.16
2021-03-25T00:00:00.000Z,10257,5235445,56.3,35431,4716134,50.71,0,0,0,0,0,0,52.22,0,47.78
2021-03-26T00:00:00.000Z,4180,5239625,56.34,13327,4729461,50.86,0,0,0,0,0,0,52.4,0,47.6
2021-03-27T00:00:00.000Z,1784,5241409,56.36,4267,4733728,50.9,0,0,0,0,0,0,52.5,0,47.5
2021-03-28T00:00:00.000Z,2110,5243519,56.39,4608,4738336,50.95,0,0,0,0,0,0,52.74,0,47.26
2021-03-29T00:00:00.000Z,6904,5250423,56.46,30014,4768350,51.28,0,0,0,0,0,0,53,0,47
2021-03-30T00:00:00.000Z,7884,5258307,56.55,22448,4790798,51.52,0,0,0,0,0,0,53.08,0,46.92
2021-03-31T00:00:00.000Z,8146,5266453,56.63,19488,4810286,51.73,0,0,0,0,0,0,53.38,0,46.62
2021-04-01T00:00:00.000Z,8197,5274650,56.72,18697,4828983,51.93,0,0,0,0,0,0,53.62,0,46.38
2021-04-02T00:00:00.000Z,2927,5277577,56.75,8126,4837109,52.02,0,0,0,0,0,0,53.71,0,46.29
2021-04-03T00:00:00.000Z,1431,5279008,56.77,2976,4840085,52.05,0,0,0,0,0,0,53.74,0,46.26
2021-04-04T00:00:00.000Z,9617,5288625,56.87,22830,4862915,52.29,0,0,0,0,0,0,53.82,0,46.18
2021-04-05T00:00:00.000Z,10358,5298983,56.98,21268,4884183,52.52,0,0,0,0,0,0,54.04,0,45.96
2021-04-06T00:00:00.000Z,9020,5308003,57.08,16786,4900969,52.7,0,0,0,0,0,0,54.21,0,45.79
2021-04-07T00:00:00.000Z,8920,5316923,57.18,15303,4916272,52.87,0,0,0,0,0,0,54.36,0,45.64
2021-04-08T00:00:00.000Z,9419,5326342,57.28,17002,4933274,53.05,0,0,0,0,0,0,54.52,0,45.48
2021-04-09T00:00:00.000Z,3604,5329946,57.32,6245,4939519,53.12,0,0,0,0,0,0,54.58,0,45.42
2021-04-10T00:00:00.000Z,1630,5331576,57.33,3519,4943038,53.15,0,0,0,0,0,0,54.61,0,45.39
2021-04-11T00:00:00.000Z,9032,5340608,57.43,14245,4957283,53.31,0,0,0,0,0,0,54.78,0,45.22
2021-04-12T00:00:00.000Z,8929,5349537,57.53,13226,4970509,53.45,0,0,0,0,0,0,54.95,0,45.05
2021-04-13T00:00:00.000Z,5835,5355372,57.59,4953,4975462,53.5,0,0,0,0,0,0,55.08,0,44.92
2021-04-14T00:00:00.000Z,3642,5359014,57.63,5299,4980761,53.56,0,0,0,0,0,0,55.18,0,44.82
2021-04-15T00:00:00.000Z,689,5359703,57.64,574,4981335,53.57,0,0,0,0,0,0,55.27,0,44.73
2021-04-16T00:00:00.000Z,3408,5363111,57.67,6641,4987976,53.64,0,0,0,0,0,0,55.33,0,44.67
2021-04-17T00:00:00.000Z,818,5363929,57.68,1970,4989946,53.66,0,0,0,0,0,0,55.35,0,44.65
2021-04-18T00:00:00.000Z,7091,5371020,57.76,7432,4997378,53.74,0,0,0,0,0,0,55.47,0,44.53
2021-04-19T00:00:00.000Z,6393,5377413,57.83,7123,5004501,53.82,0,0,0,0,0,0,55.58,0,44.42
2021-04-20T00:00:00.000Z,6275,5383688,57.89,6881,5011382,53.89,0,0,0,0,0,0,55.65,0,44.35
2021-04-21T00:00:00.000Z,6370,5390058,57.96,7100,5018482,53.97,0,0,0,0,0,0,55.71,0,44.29
2021-04-22T00:00:00.000Z,5942,5396000,58.03,7680,5026162,54.05,0,0,0,0,0,0,55.75,0,44.25
2021-04-23T00:00:00.000Z,2756,5398756,58.06,3382,5029544,54.09,0,0,0,0,0,0,55.8,0,44.2
2021-04-24T00:00:00.000Z,766,5399522,58.06,1287,5030831,54.1,0,0,0,0,0,0,55.82,0,44.18
2021-04-25T00:00:00.000Z,4827,5404349,58.12,6918,5037749,54.17,0,0,0,0,0,0,55.89,0,44.11
2021-04-26T00:00:00.000Z,5472,5409821,58.17,7885,5045634,54.26,0,0,0,0,0,0,55.96,0,44.04
2021-04-27T00:00:00.000Z,4500,5414321,58.22,6618,5052252,54.33,0,0,0,0,0,0,56.03,0,43.97
2021-04-28T00:00:00.000Z,4489,5418810,58.27,7321,5059573,54.41,0,0,0,0,0,0,56.09,0,43.91
2021-04-29T00:00:00.000Z,4369,5423179,58.32,7285,5066858,54.49,0,0,0,0,0,0,56.16,0,43.84
2021-04-30T00:00:00.000Z,1917,5425096,58.34,3195,5070053,54.52,0,0,0,0,0,0,56.19,0,43.81
2021-05-01T00:00:00.000Z,456,5425552,58.34,892,5070945,54.53,0,0,0,0,0,0,56.2,0,43.8
2021-05-02T00:00:00.000Z,3224,5428776,58.38,6085,5077030,54.6,0,0,0,0,0,0,56.26,0,43.74
2021-05-03T00:00:00.000Z,3533,5432309,58.42,5827,5082857,54.66,0,0,0,0,0,0,56.32,0,43.68
2021-05-04T00:00:00.000Z,3583,5435892,58.45,4724,5087581,54.71,0,0,0,0,0,0,56.38,0,43.62
2021-05-05T00:00:00.000Z,3286,5439178,58.49,4086,5091667,54.75,0,0,0,0,0,0,56.44,0,43.56
2021-05-06T00:00:00.000Z,3637,5442815,58.53,3138,5094805,54.79,0,0,0,0,0,0,56.5,0,43.5
2021-05-07T00:00:00.000Z,1835,5444650,58.55,2499,5097304,54.81,0,0,0,0,0,0,56.52,0,43.48
2021-05-08T00:00:00.000Z,235,5444885,58.55,505,5097809,54.82,0,0,0,0,0,0,56.53,0,43.47
2021-05-09T00:00:00.000Z,2846,5447731,58.58,4744,5102553,54.87,0,0,0,0,0,0,56.58,0,43.42
2021-05-10T00:00:00.000Z,2891,5450622,58.61,4702,5107255,54.92,0,0,0,0,0,0,56.63,0,43.37
2021-05-11T00:00:00.000Z,2621,5453243,58.64,3875,5111130,54.96,0,0,0,0,0,0,56.67,0,43.33
2021-05-12T00:00:00.000Z,2023,5455266,58.66,3333,5114463,55,0,0,0,0,0,0,56.7,0,43.3
2021-05-13T00:00:00.000Z,2036,5457302,58.69,3677,5118140,55.04,0,0,0,0,0,0,56.73,0,43.27
2021-05-14T00:00:00.000Z,971,5458273,58.7,1488,5119628,55.05,0,0,0,0,0,0,56.75,0,43.25
2021-05-15T00:00:00.000Z,250,5458523,58.7,255,5119883,55.06,0,0,0,0,0,0,56.75,0,43.25
2021-05-16T00:00:00.000Z,527,5459050,58.7,1201,5121084,55.07,0,0,0,0,0,0,56.78,0,43.22
2021-05-17T00:00:00.000Z,295,5459345,58.71,841,5121925,55.08,0,0,0,0,0,0,56.81,0,43.19
2021-05-18T00:00:00.000Z,1956,5461301,58.73,4933,5126858,55.13,0,0,0,0,0,0,56.84,0,43.16
2021-05-19T00:00:00.000Z,2222,5463523,58.75,5034,5131892,55.19,0,0,0,0,0,0,56.87,0,43.13
2021-05-20T00:00:00.000Z,2307,5465830,58.78,3876,5135768,55.23,0,0,0,0,0,0,56.9,0,43.1
2021-05-21T00:00:00.000Z,1179,5467009,58.79,1402,5137170,55.24,0,0,0,0,0,0,56.92,0,43.08
2021-05-22T00:00:00.000Z,205,5467214,58.79,395,5137565,55.25,0,0,0,0,0,0,56.92,0,43.08
2021-05-23T00:00:00.000Z,2269,5469483,58.82,3214,5140779,55.28,0,0,0,0,0,0,56.94,0,43.06
2021-05-24T00:00:00.000Z,2128,5471611,58.84,3595,5144374,55.32,0,0,0,0,0,0,56.96,0,43.04
2021-05-25T00:00:00.000Z,1815,5473426,58.86,2583,5146957,55.35,0,0,0,0,0,0,56.99,0,43.01
2021-05-26T00:00:00.000Z,1401,5474827,58.87,2500,5149457,55.37,0,0,0,0,0,0,57.03,0,42.97
2021-05-27T00:00:00.000Z,1847,5476674,58.89,3180,5152637,55.41,0,0,0,0,0,0,57.06,0,42.94
2021-05-28T00:00:00.000Z,775,5477449,58.9,1402,5154039,55.42,0,0,0,0,0,0,57.07,0,42.93
2021-05-29T00:00:00.000Z,187,5477636,58.9,223,5154262,55.43,0,0,0,0,0,0,57.07,0,42.93
2021-05-30T00:00:00.000Z,1640,5479276,58.92,1933,5156195,55.45,0,0,0,0,0,0,57.1,0,42.9
2021-05-31T00:00:00.000Z,1730,5481006,58.94,2089,5158284,55.47,0,0,0,0,0,0,57.13,0,42.87
2021-06-01T00:00:00.000Z,1371,5482377,58.95,1816,5160100,55.49,0,0,0,0,0,0,57.47,0,42.53
2021-06-02T00:00:00.000Z,1508,5483885,58.97,1604,5161704,55.51,0,0,0,0,0,0,57.25,0,42.75
2021-06-03T00:00:00.000Z,1677,5485562,58.99,1485,5163189,55.52,0,0,0,0,0,0,57.27,0,42.73
2021-06-04T00:00:00.000Z,1089,5486651,59,777,5163966,55.53,0,0,0,0,0,0,57.28,0,42.72
2021-06-05T00:00:00.000Z,180,5486831,59,158,5164124,55.53,0,0,0,0,0,0,57.29,0,42.71
2021-06-06T00:00:00.000Z,4286,5491117,59.05,1002,5165126,55.54,0,0,0,0,0,0,57.31,0,42.69
2021-06-07T00:00:00.000Z,4430,5495547,59.1,807,5165933,55.55,0,0,0,0,0,0,57.34,0,42.66
2021-06-08T00:00:00.000Z,3733,5499280,59.14,1167,5167100,55.56,0,0,0,0,0,0,57.36,0,42.64
2021-06-09T00:00:00.000Z,3609,5502889,59.18,1321,5168421,55.58,0,0,0,0,0,0,57.4,0,42.6
2021-06-10T00:00:00.000Z,3351,5506240,59.21,1292,5169713,55.59,0,0,0,0,0,0,57.42,0,42.58
2021-06-11T00:00:00.000Z,1392,5507632,59.23,580,5170293,55.6,0,0,0,0,0,0,57.43,0,42.57
2021-06-12T00:00:00.000Z,213,5507845,59.23,169,5170462,55.6,0,0,0,0,0,0,57.43,0,42.57
2021-06-13T00:00:00.000Z,3100,5510945,59.26,1256,5171718,55.61,0,0,0,0,0,0,57.45,0,42.55
2021-06-14T00:00:00.000Z,3048,5513993,59.29,1523,5173241,55.63,0,0,0,0,0,0,57.46,0,42.54
2021-06-15T00:00:00.000Z,3135,5517128,59.33,1369,5174610,55.65,0,0,0,0,0,0,57.48,0,42.52
2021-06-16T00:00:00.000Z,2725,5519853,59.36,994,5175604,55.66,0,0,0,0,0,0,57.49,0,42.51
2021-06-17T00:00:00.000Z,2721,5522574,59.39,1192,5176796,55.67,0,0,0,0,0,0,57.51,0,42.49
2021-06-18T00:00:00.000Z,1262,5523836,59.4,500,5177296,55.67,0,0,0,0,0,0,57.52,0,42.48
2021-06-19T00:00:00.000Z,240,5524076,59.4,139,5177435,55.68,0,0,0,0,0,0,57.52,0,42.48
2021-06-20T00:00:00.000Z,3312,5527388,59.44,1330,5178765,55.69,0,0,0,0,0,0,57.54,0,42.46
2021-06-21T00:00:00.000Z,5234,5532622,59.5,1210,5179975,55.7,0,0,0,0,0,0,57.56,0,42.44
2021-06-22T00:00:00.000Z,6920,5539542,59.57,1094,5181069,55.71,0,0,0,0,0,0,57.58,0,42.42
2021-06-23T00:00:00.000Z,10744,5550286,59.69,1292,5182361,55.73,0,0,0,0,0,0,57.6,0,42.4
2021-06-24T00:00:00.000Z,12037,5562323,59.81,1460,5183821,55.74,0,0,0,0,0,0,57.62,0,42.38
2021-06-25T00:00:00.000Z,7105,5569428,59.89,939,5184760,55.75,0,0,0,0,0,0,57.62,0,42.38
2021-06-26T00:00:00.000Z,2265,5571693,59.92,196,5184956,55.76,0,0,0,0,0,0,57.63,0,42.37
2021-06-27T00:00:00.000Z,13628,5585321,60.06,3434,5188390,55.79,0,0,0,0,0,0,57.65,0,42.35
2021-06-28T00:00:00.000Z,14513,5599834,60.22,3672,5192062,55.83,0,0,0,0,0,0,57.68,0,42.32
2021-06-29T00:00:00.000Z,16705,5616539,60.4,3736,5195798,55.87,0,0,0,0,0,0,57.69,0,42.31
2021-06-30T00:00:00.000Z,16479,5633018,60.57,3391,5199189,55.91,0,0,0,0,0,0,57.72,0,42.28
2021-07-01T00:00:00.000Z,16822,5649840,60.76,3368,5202557,55.95,119,119,0,0,0,0,57.78,0,42.22
2021-07-02T00:00:00.000Z,9825,5659665,60.86,1595,5204152,55.96,7,126,0,0,0,0,57.79,0,42.21
2021-07-03T00:00:00.000Z,2672,5662337,60.89,296,5204448,55.97,1,127,0,0,0,0,57.79,0,42.21
2021-07-04T00:00:00.000Z,17731,5680068,61.08,3156,5207604,56,1,128,0,0,0,0,57.85,0,42.15
2021-07-05T00:00:00.000Z,17845,5697913,61.27,3040,5210644,56.03,7,135,0,0,0,0,57.91,0,42.09
2021-07-06T00:00:00.000Z,17837,5715750,61.46,3404,5214048,56.07,11,146,0,0,0,0,57.99,0,42.01
2021-07-07T00:00:00.000Z,15521,5731271,61.63,2694,5216742,56.1,12,158,0,0,0,0,58.05,0,41.95
2021-07-08T00:00:00.000Z,16578,5747849,61.81,2872,5219614,56.13,17,175,0,0,0,0,58.12,0,41.88
2021-07-09T00:00:00.000Z,11119,5758968,61.93,1530,5221144,56.15,4,179,0,0,0,0,58.15,0,41.85
2021-07-10T00:00:00.000Z,4982,5763950,61.98,384,5221528,56.15,6,185,0,0,0,0,58.15,0,41.85
2021-07-11T00:00:00.000Z,1454,5765404,62,2847,5224375,56.18,8,193,0,0,0,0,58.22,0,41.78
2021-07-12T00:00:00.000Z,2418,5767822,62.02,3679,5228054,56.22,56,249,0,0,0,0,58.29,0,41.71
2021-07-13T00:00:00.000Z,2954,5770776,62.06,5457,5233511,56.28,124,373,0,0,0,0,58.36,0,41.64
2021-07-14T00:00:00.000Z,2738,5773514,62.09,7524,5241035,56.36,441,814,0.01,0,0,0,58.42,0,41.58
2021-07-15T00:00:00.000Z,2995,5776509,62.12,9285,5250320,56.46,374,1188,0.01,0,0,0,58.5,0,41.5
2021-07-16T00:00:00.000Z,1281,5777790,62.13,5890,5256210,56.52,66,1254,0.01,0,0,0,58.54,0,41.46
2021-07-17T00:00:00.000Z,366,5778156,62.14,1387,5257597,56.54,7,1261,0.01,0,0,0,58.55,0,41.44
2021-07-18T00:00:00.000Z,2069,5780225,62.16,9765,5267362,56.64,235,1496,0.02,0,0,0,58.6,0,41.4
2021-07-19T00:00:00.000Z,3208,5783433,62.19,11340,5278702,56.76,461,1957,0.02,0,0,0,58.65,0,41.35
2021-07-20T00:00:00.000Z,2679,5786112,62.22,11904,5290606,56.89,373,2330,0.03,0,0,0,58.72,0,41.28
2021-07-21T00:00:00.000Z,2394,5788506,62.25,11873,5302479,57.02,325,2655,0.03,0,0,0,58.81,0,41.19
2021-07-22T00:00:00.000Z,2870,5791376,62.28,13265,5315744,57.16,391,3046,0.03,0,0,0,58.93,0,41.07
2021-07-23T00:00:00.000Z,2025,5793401,62.3,8231,5323975,57.25,106,3152,0.03,0,0,0,58.99,0,41.01
2021-07-24T00:00:00.000Z,639,5794040,62.31,1477,5325452,57.27,7,3159,0.03,0,0,0,58.99,0,41
2021-07-25T00:00:00.000Z,4413,5798453,62.35,15486,5340938,57.43,223,3382,0.04,0,0,0,59.1,0,40.89
2021-07-26T00:00:00.000Z,5162,5803615,62.41,13523,5354461,57.58,323,3705,0.04,0,0,0,59.24,0,40.75
2021-07-27T00:00:00.000Z,5485,5809100,62.47,13567,5368028,57.73,413,4118,0.04,0,0,0,59.37,0.01,40.62
2021-07-28T00:00:00.000Z,3982,5813082,62.51,12338,5380366,57.86,472,4590,0.05,0,0,0,59.5,0.01,40.49
2021-07-29T00:00:00.000Z,4656,5817738,62.56,14190,5394556,58.01,530,5120,0.06,0,0,0,59.65,0.01,40.33
2021-07-30T00:00:00.000Z,2643,5820381,62.59,10847,5405403,58.13,4122,9242,0.1,0,0,0,59.74,0.02,40.25
2021-07-31T00:00:00.000Z,1402,5821783,62.6,3546,5408949,58.17,6159,15401,0.17,0,0,0,59.75,0.02,40.23
2021-08-01T00:00:00.000Z,3072,5824855,62.64,3361,5412310,58.2,31046,46447,0.5,0,0,0,59.91,0.02,40.06
2021-08-02T00:00:00.000Z,3126,5827981,62.67,3165,5415475,58.24,58509,104956,1.13,0,0,0,60.06,0.03,39.91
2021-08-03T00:00:00.000Z,3380,5831361,62.71,3318,5418793,58.27,78951,183907,1.98,0,0,0,60.21,0.03,39.76
2021-08-04T00:00:00.000Z,3520,5834881,62.75,3246,5422039,58.31,80762,264669,2.85,0,0,0,60.34,0.03,39.63
2021-08-05T00:00:00.000Z,4504,5839385,62.79,3566,5425605,58.34,88440,353109,3.8,0,0,0,60.49,0.04,39.47
2021-08-06T00:00:00.000Z,2430,5841815,62.82,1844,5427449,58.36,44741,397850,4.28,0,0,0,60.6,0.04,39.36
2021-08-07T00:00:00.000Z,1026,5842841,62.83,691,5428140,58.37,27352,425202,4.57,0,0,0,60.63,0.04,39.32
2021-08-08T00:00:00.000Z,4987,5847828,62.88,3075,5431215,58.4,80085,505287,5.43,0,0,0,60.68,0.04,39.28
2021-08-09T00:00:00.000Z,5336,5853164,62.94,3052,5434267,58.44,76487,581774,6.26,0,0,0,60.72,0.04,39.24
2021-08-10T00:00:00.000Z,5542,5858706,63,3198,5437465,58.47,75425,657199,7.07,0,0,0,60.75,0.04,39.2
2021-08-11T00:00:00.000Z,5690,5864396,63.06,2937,5440402,58.5,62634,719833,7.74,0,0,0,60.79,0.04,39.17
2021-08-12T00:00:00.000Z,7023,5871419,63.14,3284,5443686,58.54,59459,779292,8.38,0,0,0,60.83,0.04,39.12
2021-08-13T00:00:00.000Z,3809,5875228,63.18,2059,5445745,58.56,43869,823161,8.85,0,0,0,60.84,0.05,39.11
2021-08-14T00:00:00.000Z,2247,5877475,63.2,849,5446594,58.57,44484,867645,9.33,0,0,0,60.85,0.05,39.1
2021-08-15T00:00:00.000Z,7139,5884614,63.28,4529,5451123,58.62,97977,965622,10.38,0,0,0,60.89,0.05,39.06
2021-08-16T00:00:00.000Z,6985,5891599,63.36,4738,5455861,58.67,89513,1055135,11.35,0,0,0,60.92,0.04,39.03
2021-08-17T00:00:00.000Z,7570,5899169,63.44,5130,5460991,58.72,83315,1138450,12.24,0,0,0,60.96,0.04,39
2021-08-18T00:00:00.000Z,8634,5907803,63.53,4599,5465590,58.77,69258,1207708,12.99,0,0,0,60.99,0.04,38.96
2021-08-19T00:00:00.000Z,10068,5917871,63.64,5210,5470800,58.83,65971,1273679,13.7,0,0,0,61.03,0.04,38.92
2021-08-20T00:00:00.000Z,4763,5922634,63.69,2821,5473621,58.86,60447,1334126,14.35,0,0,0,61.05,0.05,38.9
2021-08-21T00:00:00.000Z,3490,5926124,63.73,1574,5475195,58.88,50723,1384849,14.89,0,0,0,61.06,0.05,38.89
2021-08-22T00:00:00.000Z,9823,5935947,63.83,4799,5479994,58.93,105099,1489948,16.02,0,0,0,61.12,0.04,38.84
2021-08-23T00:00:00.000Z,10930,5946877,63.95,4442,5484436,58.98,94009,1583957,17.03,0,0,0,61.17,0.04,38.79
2021-08-24T00:00:00.000Z,11725,5958602,64.08,4696,5489132,59.03,98533,1682490,18.09,0,0,0,61.23,0.04,38.73
2021-08-25T00:00:00.000Z,9614,5968216,64.18,4477,5493609,59.08,99522,1782012,19.16,0,0,0,61.29,0.04,38.67
2021-08-26T00:00:00.000Z,10109,5978325,64.29,5051,5498660,59.13,101202,1883214,20.25,0,0,0,61.36,0.03,38.61
2021-08-27T00:00:00.000Z,4322,5982647,64.33,2778,5501438,59.16,56688,1939902,20.86,0,0,0,61.35,0.04,38.61
2021-08-28T00:00:00.000Z,3697,5986344,64.37,1494,5502932,59.18,33536,1973438,21.22,0,0,0,61.4,0.04,38.57
2021-08-29T00:00:00.000Z,10327,5996671,64.49,5930,5508862,59.24,79523,2052961,22.08,0,0,0,61.46,0.03,38.5
2021-08-30T00:00:00.000Z,12335,6009006,64.62,7012,5515874,59.31,115984,2168945,23.32,0,0,0,61.53,0.03,38.44
2021-08-31T00:00:00.000Z,12079,6021085,64.75,6518,5522392,59.39,114856,2283801,24.56,0,0,0,61.6,0.03,38.37
2021-09-01T00:00:00.000Z,9036,6030121,64.84,6027,5528419,59.45,112471,2396272,25.77,0,0,0,61.43,0.03,38.54
2021-09-02T00:00:00.000Z,8783,6038904,64.94,7176,5535595,59.53,111522,2507794,26.97,0,0,0,61.49,0.03,38.48
2021-09-03T00:00:00.000Z,3745,6042649,64.98,4108,5539703,59.57,58878,2566672,27.6,0,0,0,61.56,0.03,38.42
2021-09-04T00:00:00.000Z,2691,6045340,65.01,2017,5541720,59.59,29944,2596616,27.92,0,0,0,61.59,0.03,38.38
2021-09-05T00:00:00.000Z,6991,6052331,65.08,6455,5548175,59.66,73320,2669936,28.71,0,0,0,61.68,0.03,38.29
2021-09-06T00:00:00.000Z,2829,6055160,65.11,2705,5550880,59.69,22794,2692730,28.96,0,0,0,61.77,0.03,38.2
2021-09-07T00:00:00.000Z,1198,6056358,65.13,875,5551755,59.7,5396,2698126,29.01,0,0,0,61.85,0.03,38.12
2021-09-08T00:00:00.000Z,1378,6057736,65.14,1190,5552945,59.71,6619,2704745,29.09,0,0,0,61.93,0.03,38.05
2021-09-09T00:00:00.000Z,7086,6064822,65.22,12563,5565508,59.85,73834,2778579,29.88,0,0,0,62.02,0.03,37.95
2021-09-10T00:00:00.000Z,3254,6068076,65.25,5008,5570516,59.9,37929,2816508,30.29,0,0,0,62.06,0.03,37.91
2021-09-11T00:00:00.000Z,2104,6070180,65.28,2501,5573017,59.93,14814,2831322,30.45,0,0,0,62.08,0.03,37.89
2021-09-12T00:00:00.000Z,6112,6076292,65.34,8584,5581601,60.02,54121,2885443,31.03,0,0,0,62.16,0.03,37.81
2021-09-13T00:00:00.000Z,5606,6081898,65.4,8255,5589856,60.11,47976,2933419,31.54,0,0,0,62.15,0.03,37.82
2021-09-14T00:00:00.000Z,4958,6086856,65.45,7416,5597272,60.19,48846,2982265,32.07,0,0,0,62.2,0.03,37.77
2021-09-15T00:00:00.000Z,1743,6088599,65.47,2713,5599985,60.22,16683,2998948,32.25,0,0,0,62.25,0.03,37.72
2021-09-16T00:00:00.000Z,337,6088936,65.48,544,5600529,60.23,1740,3000688,32.27,0,0,0,62.37,0.03,37.6
2021-09-17T00:00:00.000Z,3676,6092612,65.52,7013,5607542,60.3,42895,3043583,32.73,0,0,0,62.42,0.03,37.54
2021-09-18T00:00:00.000Z,2255,6094867,65.54,2941,5610483,60.33,12782,3056365,32.87,0,0,0,62.45,0.03,37.52
2021-09-19T00:00:00.000Z,5940,6100807,65.61,10710,5621193,60.45,44327,3100692,33.34,0,0,0,62.55,0.03,37.42
2021-09-20T00:00:00.000Z,3241,6104048,65.64,4640,5625833,60.5,16703,3117395,33.52,0,0,0,62.63,0.03,37.34
2021-09-21T00:00:00.000Z,1334,6105382,65.65,2053,5627886,60.52,3474,3120869,33.56,0,0,0,62.69,0.03,37.28
2021-09-22T00:00:00.000Z,4256,6109638,65.7,7244,5635130,60.6,25064,3145933,33.83,0,0,0,62.72,0.03,37.25
2021-09-23T00:00:00.000Z,4387,6114025,65.75,5903,5641033,60.66,27829,3173762,34.13,0,0,0,62.75,0.03,37.22
2021-09-24T00:00:00.000Z,3199,6117224,65.78,4182,5645215,60.71,27716,3201478,34.43,0,0,0,62.82,0.03,37.15
2021-09-25T00:00:00.000Z,2073,6119297,65.8,2256,5647471,60.73,10440,3211918,34.54,0,0,0,62.85,0.03,37.12
2021-09-26T00:00:00.000Z,5604,6124901,65.86,5968,5653439,60.79,36262,3248180,34.93,0,0,0,62.96,0.03,37
2021-09-27T00:00:00.000Z,4692,6129593,65.91,4465,5657904,60.84,30449,3278629,35.26,0,0,0,63.02,0.03,36.94
2021-09-28T00:00:00.000Z,1465,6131058,65.93,1179,5659083,60.86,6249,3284878,35.32,0,0,0,63.06,0.04,36.91
2021-09-29T00:00:00.000Z,9619,6140677,66.03,8343,5667426,60.94,60321,3345199,35.97,0,0,0,63.13,0.03,36.84
2021-09-30T00:00:00.000Z,10968,6151645,66.15,8568,5675994,61.04,79697,3424896,36.83,0,0,0,63.18,0.03,36.79
2021-10-01T00:00:00.000Z,5119,6156764,66.21,3871,5679865,61.08,46537,3471433,37.33,0,0,0,63.23,0.03,36.73
2021-10-02T00:00:00.000Z,2859,6159623,66.24,2123,5681988,61.1,22429,3493862,37.57,0,0,0,63.26,0.03,36.71
2021-10-03T00:00:00.000Z,11666,6171289,66.36,7271,5689259,61.18,70721,3564583,38.33,0,0,0,63.35,0.03,36.62
2021-10-04T00:00:00.000Z,10316,6181605,66.47,6754,5696013,61.25,51902,3616485,38.89,0,0,0,63.4,0.03,36.57
2021-10-05T00:00:00.000Z,8454,6190059,66.56,5305,5701318,61.31,40472,3656957,39.33,0,0,0,63.41,0.03,36.55
2021-10-06T00:00:00.000Z,7539,6197598,66.65,4174,5705492,61.35,34134,3691091,39.69,0,0,0,63.52,0.03,36.45
2021-10-07T00:00:00.000Z,6889,6204487,66.72,4006,5709498,61.4,34055,3725146,40.06,0,0,0,63.63,0.03,36.34
2021-10-08T00:00:00.000Z,3086,6207573,66.75,2633,5712131,61.43,19241,3744387,40.27,0,0,0,63.68,0.03,36.29
2021-10-09T00:00:00.000Z,1335,6208908,66.77,1440,5713571,61.44,7440,3751827,40.35,0,0,0,63.71,0.03,36.26
2021-10-10T00:00:00.000Z,4675,6213583,66.82,3743,5717314,61.48,21512,3773339,40.58,0,0,0,63.82,0.04,36.14
2021-10-11T00:00:00.000Z,4293,6217876,66.86,2941,5720255,61.51,17257,3790596,40.76,0,0,0,63.91,0.04,36.05
2021-10-12T00:00:00.000Z,3971,6221847,66.91,3001,5723256,61.55,15354,3805950,40.93,0,0,0,63.99,0.05,35.96
2021-10-13T00:00:00.000Z,3482,6225329,66.94,2446,5725702,61.57,13580,3819530,41.07,0,0,0,64.09,0.05,35.86
2021-10-14T00:00:00.000Z,3865,6229194,66.99,2681,5728383,61.6,16562,3836092,41.25,0,0,0,64.19,0.06,35.75
2021-10-15T00:00:00.000Z,1696,6230890,67,1679,5730062,61.62,9005,3845097,41.35,0,0,0,64.23,0.07,35.7
2021-10-16T00:00:00.000Z,725,6231615,67.01,951,5731013,61.63,4034,3849131,41.39,0,0,0,64.25,0.08,35.67
2021-10-17T00:00:00.000Z,3087,6234702,67.04,2520,5733533,61.66,12792,3861923,41.53,0,0,0,64.36,0.09,35.56
2021-10-18T00:00:00.000Z,2454,6237156,67.07,1682,5735215,61.67,10065,3871988,41.64,0,0,0,64.43,0.1,35.47
2021-10-19T00:00:00.000Z,2393,6239549,67.1,1277,5736492,61.69,9296,3881284,41.74,0,0,0,64.49,0.1,35.4
2021-10-20T00:00:00.000Z,2431,6241980,67.12,2302,5738794,61.71,10090,3891374,41.85,0,0,0,64.14,0.52,35.34
2021-10-21T00:00:00.000Z,3032,6245012,67.16,3089,5741883,61.75,12158,3903532,41.98,0,0,0,54.23,10.41,35.36
2021-10-22T00:00:00.000Z,1274,6246286,67.17,1428,5743311,61.76,5827,3909359,42.04,0,0,0,54.36,10.26,35.38
2021-10-23T00:00:00.000Z,570,6246856,67.18,1262,5744573,61.77,2560,3911919,42.07,0,0,0,54.42,10.19,35.39
2021-10-24T00:00:00.000Z,2512,6249368,67.2,2652,5747225,61.8,9852,3921771,42.17,0,0,0,54.22,10.43,35.35
2021-10-25T00:00:00.000Z,2632,6252000,67.23,2741,5749966,61.83,8503,3930274,42.26,0,0,0,54.59,10.22,35.19
2021-10-26T00:00:00.000Z,2374,6254374,67.26,2045,5752011,61.85,8516,3938790,42.36,0,0,0,54.64,10.26,35.1
2021-10-27T00:00:00.000Z,2285,6256659,67.28,2560,5754571,61.88,7950,3946740,42.44,0,0,0,54.58,10.37,35.06
2021-10-28T00:00:00.000Z,2496,6259155,67.31,2771,5757342,61.91,8660,3955400,42.53,0,0,0,54.69,10.76,34.55
2021-10-29T00:00:00.000Z,897,6260052,67.32,1144,5758486,61.92,4129,3959529,42.58,0,0,0,54.73,10.75,34.52
2021-10-30T00:00:00.000Z,363,6260415,67.32,529,5759015,61.93,1709,3961238,42.6,0,0,0,54.68,10.81,34.52
2021-10-31T00:00:00.000Z,2258,6262673,67.35,2490,5761505,61.96,8250,3969488,42.69,0,0,0,54.83,10.7,34.47
2021-11-01T00:00:00.000Z,1733,6264406,67.36,2088,5763593,61.98,6476,3975964,42.76,0,0,0,54.95,10.63,34.42
2021-11-02T00:00:00.000Z,2024,6266430,67.39,2042,5765635,62,6284,3982248,42.82,0,0,0,54.89,10.69,34.42
2021-11-03T00:00:00.000Z,1757,6268187,67.41,1888,5767523,62.02,5550,3987798,42.88,0,0,0,54.86,10.75,34.39
2021-11-04T00:00:00.000Z,2105,6270292,67.43,2796,5770319,62.05,7126,3994924,42.96,0,0,0,54.85,10.81,34.33
2021-11-05T00:00:00.000Z,783,6271075,67.44,898,5771217,62.06,3477,3998401,43,0,0,0,54.85,10.83,34.32
2021-11-06T00:00:00.000Z,344,6271419,67.44,384,5771601,62.07,1371,3999772,43.01,0,0,0,54.82,10.86,34.32
2021-11-07T00:00:00.000Z,1579,6272998,67.46,1768,5773369,62.08,6130,4005902,43.08,0,0,0,54.92,10.8,34.28
2021-11-08T00:00:00.000Z,1516,6274514,67.47,1598,5774967,62.1,5405,4011307,43.14,0,0,0,55.01,10.75,34.24
2021-11-09T00:00:00.000Z,1427,6275941,67.49,1602,5776569,62.12,5327,4016634,43.19,0,0,0,55.05,10.74,34.21
2021-11-10T00:00:00.000Z,1421,6277362,67.5,1653,5778222,62.14,4776,4021410,43.24,0,0,0,55.08,10.73,34.19
2021-11-11T00:00:00.000Z,1624,6278986,67.52,1941,5780163,62.16,5706,4027116,43.31,0,0,0,55.15,10.69,34.15
2021-11-12T00:00:00.000Z,632,6279618,67.53,820,5780983,62.17,2920,4030036,43.34,0,0,0,55.17,10.69,34.14
2021-11-13T00:00:00.000Z,252,6279870,67.53,284,5781267,62.17,1126,4031162,43.35,0,0,0,55.14,10.72,34.14
2021-11-14T00:00:00.000Z,1536,6281406,67.55,1636,5782903,62.19,5108,4036270,43.4,0,0,0,55.21,10.68,34.11
2021-11-15T00:00:00.000Z,1272,6282678,67.56,1616,5784519,62.2,4767,4041037,43.46,0,0,0,55.28,10.63,34.09
2021-11-16T00:00:00.000Z,1271,6283949,67.57,1406,5785925,62.22,4339,4045376,43.5,0,0,0,55.32,10.62,34.07
2021-11-17T00:00:00.000Z,1201,6285150,67.59,1559,5787484,62.24,3908,4049284,43.54,0,0,0,55.35,10.6,34.05
2021-11-18T00:00:00.000Z,1358,6286508,67.6,1685,5789169,62.25,5004,4054288,43.6,0,0,0,55.41,10.58,34.02
2021-11-19T00:00:00.000Z,588,6287096,67.61,757,5789926,62.26,2451,4056739,43.62,0,0,0,55.42,10.57,34.01
2021-11-20T00:00:00.000Z,236,6287332,67.61,254,5790180,62.26,926,4057665,43.63,0,0,0,55.41,10.58,34
2021-11-21T00:00:00.000Z,1410,6288742,67.63,1536,5791716,62.28,4875,4062540,43.69,0,0,0,55.47,10.54,33.98
2021-11-22T00:00:00.000Z,1680,6290422,67.64,1516,5793232,62.3,4232,4066772,43.73,0,0,0,55.54,10.5,33.96
2021-11-23T00:00:00.000Z,8615,6299037,67.74,1677,5794909,62.32,3999,4070771,43.78,0,0,0,55.57,10.48,33.95
2021-11-24T00:00:00.000Z,9348,6308385,67.84,1312,5796221,62.33,3918,4074689,43.82,0,0,0,55.6,10.44,33.95
2021-11-25T00:00:00.000Z,9809,6318194,67.94,1598,5797819,62.35,4832,4079521,43.87,0,0,0,55.64,10.43,33.93
2021-11-26T00:00:00.000Z,5611,6323805,68,745,5798564,62.35,2797,4082318,43.9,0,0,0,55.63,10.45,33.92
2021-11-27T00:00:00.000Z,4777,6328582,68.05,321,5798885,62.36,1160,4083478,43.91,0,0,0,55.62,10.46,33.92
2021-11-28T00:00:00.000Z,10148,6338730,68.16,1476,5800361,62.37,4896,4088374,43.96,0,0,0,55.67,10.43,33.9
2021-11-29T00:00:00.000Z,9039,6347769,68.26,1129,5801490,62.39,4366,4092740,44.01,0,0,0,55.73,10.39,33.88
2021-11-30T00:00:00.000Z,10041,6357810,68.37,1029,5802519,62.4,4081,4096821,44.06,0,0,0,55.77,10.37,33.86
2021-12-01T00:00:00.000Z,8624,6366434,68.46,1092,5803611,62.41,4435,4101256,44.1,5,5,0,55.79,10.36,33.84
2021-12-02T00:00:00.000Z,9169,6375603,68.56,1448,5805059,62.42,5117,4106373,44.16,6,11,0,55.84,10.34,33.82
2021-12-03T00:00:00.000Z,6331,6381934,68.63,670,5805729,62.43,2859,4109232,44.19,1,12,0,55.86,10.33,33.81
2021-12-04T00:00:00.000Z,2508,6384442,68.66,232,5805961,62.43,915,4110147,44.2,3,15,0,55.85,10.34,33.81
2021-12-05T00:00:00.000Z,8333,6392775,68.74,1251,5807212,62.45,4679,4114826,44.25,1,16,0,55.9,10.31,33.79
2021-12-06T00:00:00.000Z,6722,6399497,68.82,1194,5808406,62.46,4346,4119172,44.3,4,20,0,55.95,10.27,33.78
2021-12-07T00:00:00.000Z,5554,6405051,68.88,1496,5809902,62.48,3956,4123128,44.34,9,29,0,55.99,10.25,33.76
2021-12-08T00:00:00.000Z,4929,6409980,68.93,1198,5811100,62.49,3874,4127002,44.38,10,39,0,56.03,10.22,33.75
2021-12-09T00:00:00.000Z,6237,6416217,69,1234,5812334,62.5,4499,4131501,44.43,8,47,0,56.08,10.19,33.73
2021-12-10T00:00:00.000Z,3005,6419222,69.03,699,5813033,62.51,2676,4134177,44.46,4,51,0,56.1,10.18,33.72
2021-12-11T00:00:00.000Z,1491,6420713,69.05,251,5813284,62.51,1012,4135189,44.47,0,51,0,56.1,10.18,33.71
2021-12-12T00:00:00.000Z,7273,6427986,69.12,1442,5814726,62.53,5245,4140434,44.52,3,54,0,56.16,10.15,33.69
2021-12-13T00:00:00.000Z,6176,6434162,69.19,1371,5816097,62.54,4345,4144779,44.57,5,59,0,56.21,10.11,33.67
2021-12-14T00:00:00.000Z,7315,6441477,69.27,6100,5822197,62.61,4928,4149707,44.62,11,70,0,56.27,10.09,33.65
2021-12-15T00:00:00.000Z,7201,6448678,69.35,7401,5829598,62.69,5439,4155146,44.68,7,77,0,56.34,10.06,33.6
2021-12-16T00:00:00.000Z,8079,6456757,69.43,8609,5838207,62.78,6552,4161698,44.75,8,85,0,56.53,10.05,33.42
2021-12-17T00:00:00.000Z,4403,6461160,69.48,5135,5843342,62.84,3946,4165644,44.8,3,88,0,56.64,10.05,33.3
2021-12-18T00:00:00.000Z,3940,6465100,69.52,2913,5846255,62.87,1353,4166997,44.81,2,90,0,56.73,10.07,33.2
2021-12-19T00:00:00.000Z,6980,6472080,69.6,9331,5855586,62.97,6267,4173264,44.88,5,95,0,56.92,10.04,33.04
2021-12-20T00:00:00.000Z,7969,6480049,69.68,7514,5863100,63.05,5437,4178701,44.94,9,104,0,57.07,10.02,32.91
2021-12-21T00:00:00.000Z,9547,6489596,69.79,8644,5871744,63.14,6477,4185178,45.01,8,112,0,57.27,10.01,32.71
2021-12-22T00:00:00.000Z,9665,6499261,69.89,8148,5879892,63.23,6240,4191418,45.07,12,124,0,57.49,10,32.52
2021-12-23T00:00:00.000Z,11540,6510801,70.01,10261,5890153,63.34,8137,4199555,45.16,15,139,0,57.7,9.97,32.33
2021-12-24T00:00:00.000Z,5868,6516669,70.08,6240,5896393,63.41,5274,4204829,45.22,12,151,0,57.83,9.96,32.21
2021-12-25T00:00:00.000Z,3338,6520007,70.11,2565,5898958,63.43,2020,4206849,45.24,6,157,0,57.9,9.96,32.15
2021-12-26T00:00:00.000Z,10653,6530660,70.23,8907,5907865,63.53,8193,4215042,45.33,8,165,0,58.1,9.92,31.98
2021-12-27T00:00:00.000Z,10368,6541028,70.34,7143,5915008,63.61,8182,4223224,45.41,21,186,0,58.27,9.9,31.83
2021-12-28T00:00:00.000Z,11373,6552401,70.46,7451,5922459,63.69,9626,4232850,45.52,24,210,0,58.46,9.88,31.66
2021-12-29T00:00:00.000Z,9934,6562335,70.57,5959,5928418,63.75,8362,4241212,45.61,17,227,0,58.64,9.85,31.51
2021-12-30T00:00:00.000Z,11008,6573343,70.69,7734,5936152,63.83,12236,4253448,45.74,10,237,0,58.84,9.82,31.34
2021-12-31T00:00:00.000Z,4828,6578171,70.74,3671,5939823,63.87,7291,4260739,45.82,134,371,0,58.9,9.79,31.3
2022-01-01T00:00:00.000Z,1992,6580163,70.76,1591,5941414,63.89,2741,4263480,45.85,65,436,0,58.93,9.79,31.28
2022-01-02T00:00:00.000Z,10215,6590378,70.87,6486,5947900,63.96,13000,4276480,45.99,590,1026,0.01,59.14,9.76,31.1
2022-01-03T00:00:00.000Z,9381,6599759,70.97,5257,5953157,64.02,11328,4287808,46.11,25055,26081,0.28,59.29,9.71,31
2022-01-04T00:00:00.000Z,8969,6608728,71.07,5943,5959100,64.08,10519,4298327,46.22,50652,76733,0.83,59.46,9.68,30.86
2022-01-05T00:00:00.000Z,8551,6617279,71.16,5736,5964836,64.14,10486,4308813,46.33,59578,136311,1.47,59.56,9.65,30.79
2022-01-06T00:00:00.000Z,10339,6627618,71.27,7960,5972796,64.23,13526,4322339,46.48,63993,200304,2.15,59.81,9.63,30.56
2022-01-07T00:00:00.000Z,4752,6632370,71.32,4555,5977351,64.28,8151,4330490,46.57,31133,231437,2.49,59.89,9.61,30.49
2022-01-08T00:00:00.000Z,2750,6635120,71.35,2451,5979802,64.3,5499,4335989,46.63,27628,259065,2.79,59.9,9.64,30.46
2022-01-09T00:00:00.000Z,9308,6644428,71.45,7721,5987523,64.39,11862,4347851,46.75,66760,325825,3.5,60.06,9.59,30.35
2022-01-10T00:00:00.000Z,8353,6652781,71.54,7650,5995173,64.47,11864,4359715,46.88,64760,390585,4.2,60.21,9.54,30.25
2022-01-11T00:00:00.000Z,8103,6660884,71.63,8622,6003795,64.56,11963,4371678,47.01,56652,447237,4.81,60.38,9.49,30.13
2022-01-12T00:00:00.000Z,7279,6668163,71.71,8306,6012101,64.65,11107,4382785,47.13,44623,491860,5.29,60.51,9.45,30.04
2022-01-13T00:00:00.000Z,7512,6675675,71.79,9617,6021718,64.75,11537,4394322,47.25,34749,526609,5.66,60.7,9.35,29.94
2022-01-14T00:00:00.000Z,2555,6678230,71.81,4931,6026649,64.81,6138,4400460,47.32,11138,537747,5.78,60.79,9.31,29.9
2022-01-15T00:00:00.000Z,1466,6679696,71.83,3166,6029815,64.84,3878,4404338,47.36,5715,543462,5.84,60.83,9.29,29.87
2022-01-16T00:00:00.000Z,3818,6683514,71.87,8523,6038338,64.93,7678,4412016,47.44,19989,563451,6.06,60.97,9.2,29.82
2022-01-17T00:00:00.000Z,2808,6686322,71.9,7045,6045383,65.01,6165,4418181,47.51,17834,581285,6.25,61.09,9.13,29.78
2022-01-18T00:00:00.000Z,2475,6688797,71.93,7381,6052764,65.09,5522,4423703,47.57,14813,596098,6.41,61.23,9.07,29.7
2022-01-19T00:00:00.000Z,1915,6690712,71.95,6363,6059127,65.16,4514,4428217,47.62,8456,604554,6.5,61.37,8.98,29.65
2022-01-20T00:00:00.000Z,1779,6692491,71.97,6965,6066092,65.23,4785,4433002,47.67,8040,612594,6.59,61.44,8.85,29.71
2022-01-21T00:00:00.000Z,904,6693395,71.98,3725,6069817,65.27,2635,4435637,47.7,3358,615952,6.62,61.51,8.81,29.68
2022-01-22T00:00:00.000Z,328,6693723,71.98,1461,6071278,65.29,1059,4436696,47.71,1113,617065,6.64,61.51,8.75,29.74
2022-01-23T00:00:00.000Z,1066,6694789,71.99,5628,6076906,65.35,2874,4439570,47.74,6081,623146,6.7,61.61,8.7,29.69
2022-01-24T00:00:00.000Z,758,6695547,72,4480,6081386,65.4,2259,4441829,47.77,5054,628200,6.76,61.73,8.62,29.65
2022-01-25T00:00:00.000Z,741,6696288,72.01,4398,6085784,65.44,2171,4444000,47.79,7102,635302,6.83,61.9,8.51,29.59
2022-01-26T00:00:00.000Z,614,6696902,72.02,3283,6089067,65.48,1604,4445604,47.81,4261,639563,6.88,62.02,8.42,29.57
2022-01-27T00:00:00.000Z,797,6697699,72.02,4405,6093472,65.53,2001,4447605,47.83,5439,645002,6.94,62.12,8.35,29.52
2022-01-28T00:00:00.000Z,394,6698093,72.03,2372,6095844,65.55,1169,4448774,47.84,3449,648451,6.97,62.16,8.33,29.5
2022-01-29T00:00:00.000Z,124,6698217,72.03,1045,6096889,65.56,424,4449198,47.84,1160,649611,6.99,62.23,8.29,29.48
2022-01-30T00:00:00.000Z,768,6698985,72.04,4719,6101608,65.61,2016,4451214,47.87,8098,657709,7.07,62.3,8.24,29.46
2022-01-31T00:00:00.000Z,528,6699513,72.04,3184,6104792,65.65,1608,4452822,47.88,6472,664181,7.14,62.39,8.17,29.43
2022-02-01T00:00:00.000Z,477,6699990,72.05,2804,6107596,65.68,1517,4454339,47.9,5719,669900,7.2,62.45,8.15,29.4
2022-02-02T00:00:00.000Z,373,6700363,72.05,2390,6109986,65.7,1377,4455716,47.91,5071,674971,7.26,62.28,8.13,29.59
2022-02-03T00:00:00.000Z,445,6700808,72.06,2775,6112761,65.73,1453,4457169,47.93,5605,680576,7.32,62.34,8.08,29.57
2022-02-04T00:00:00.000Z,174,6700982,72.06,989,6113750,65.74,753,4457922,47.94,2454,683030,7.35,62.37,8.06,29.57
2022-02-05T00:00:00.000Z,62,6701044,72.06,340,6114090,65.75,215,4458137,47.94,420,683450,7.35,62.34,8.09,29.56
2022-02-06T00:00:00.000Z,407,6701451,72.06,2322,6116412,65.77,1342,4459479,47.95,5684,689134,7.41,62.41,8.05,29.55
2022-02-07T00:00:00.000Z,282,6701733,72.07,1306,6117718,65.79,980,4460459,47.97,5960,695094,7.47,62.47,8.01,29.52
2022-02-08T00:00:00.000Z,315,6702048,72.07,1497,6119215,65.8,1063,4461522,47.98,6137,701231,7.54,62.54,7.97,29.49
2022-02-09T00:00:00.000Z,253,6702301,72.07,1102,6120317,65.81,941,4462463,47.99,4570,705801,7.59,62.6,7.95,29.45
2022-02-10T00:00:00.000Z,270,6702571,72.08,1293,6121610,65.83,930,4463393,48,4815,710616,7.64,62.63,7.93,29.44
2022-02-11T00:00:00.000Z,211,6702782,72.08,554,6122164,65.83,513,4463906,48,2534,713150,7.67,62.67,7.91,29.42
2022-02-12T00:00:00.000Z,31,6702813,72.08,90,6122254,65.84,126,4464032,48,268,713418,7.67,62.67,7.91,29.41
2022-02-13T00:00:00.000Z,286,6703099,72.08,945,6123199,65.85,965,4464997,48.01,4995,718413,7.73,62.73,7.87,29.39
2022-02-14T00:00:00.000Z,179,6703278,72.08,625,6123824,65.85,747,4465744,48.02,3143,721556,7.76,62.89,7.74,29.36
2022-02-15T00:00:00.000Z,265,6703543,72.09,764,6124588,65.86,929,4466673,48.03,3815,725371,7.8,62.92,7.73,29.35
2022-02-16T00:00:00.000Z,179,6703722,72.09,577,6125165,65.87,800,4467473,48.04,2487,727858,7.83,62.95,7.72,29.34
2022-02-17T00:00:00.000Z,247,6703969,72.09,738,6125903,65.87,771,4468244,48.05,3057,730915,7.86,62.96,7.7,29.34
2022-02-18T00:00:00.000Z,128,6704097,72.09,333,6126236,65.88,433,4468677,48.05,1118,732033,7.87,62.98,7.69,29.33
2022-02-19T00:00:00.000Z,33,6704130,72.09,83,6126319,65.88,79,4468756,48.05,79,732112,7.87,62.99,7.69,29.32
2022-02-20T00:00:00.000Z,202,6704332,72.1,604,6126923,65.89,717,4469473,48.06,2574,734686,7.9,63.01,7.67,29.32
2022-02-21T00:00:00.000Z,173,6704505,72.1,412,6127335,65.89,488,4469961,48.07,1542,736228,7.92,63.04,7.65,29.31
2022-02-22T00:00:00.000Z,158,6704663,72.1,452,6127787,65.9,561,4470522,48.07,1870,738098,7.94,63.05,7.65,29.3
2022-02-23T00:00:00.000Z,109,6704772,72.1,352,6128139,65.9,450,4470972,48.08,1152,739250,7.95,63.06,7.65,29.29
2022-02-24T00:00:00.000Z,138,6704910,72.1,454,6128593,65.9,563,4471535,48.08,1492,740742,7.97,63.05,7.66,29.29
2022-02-25T00:00:00.000Z,58,6704968,72.1,139,6128732,65.91,188,4471723,48.09,455,741197,7.97,63.06,7.66,29.28
2022-02-26T00:00:00.000Z,15,6704983,72.1,28,6128760,65.91,156,4471879,48.09,35,741232,7.97,63.05,7.67,29.28
2022-02-27T00:00:00.000Z,111,6705094,72.1,341,6129101,65.91,448,4472327,48.09,1118,742350,7.98,63.05,7.67,29.28
2022-02-28T00:00:00.000Z,109,6705203,72.1,271,6129372,65.91,419,4472746,48.1,906,743256,7.99,63.07,7.65,29.28
2022-03-01T00:00:00.000Z,97,6705300,72.11,280,6129652,65.92,371,4473117,48.1,796,744052,8,63.1,7.63,29.27
2022-03-02T00:00:00.000Z,77,6705377,72.11,198,6129850,65.92,323,4473440,48.11,694,744746,8.01,63.11,7.62,29.27
2022-03-03T00:00:00.000Z,156,6705533,72.11,369,6130219,65.92,496,4473936,48.11,985,745731,8.02,63.05,7.67,29.27
2022-03-04T00:00:00.000Z,52,6705585,72.11,166,6130385,65.92,164,4474100,48.11,227,745958,8.02,63.05,7.68,29.27
2022-03-05T00:00:00.000Z,3,6705588,72.11,25,6130410,65.92,43,4474143,48.11,31,745989,8.02,63.04,7.69,29.27
2022-03-06T00:00:00.000Z,98,6705686,72.11,258,6130668,65.93,413,4474556,48.12,759,746748,8.03,63.04,7.69,29.27
2022-03-07T00:00:00.000Z,87,6705773,72.11,259,6130927,65.93,346,4474902,48.12,604,747352,8.04,63.05,7.69,29.26
2022-03-08T00:00:00.000Z,98,6705871,72.11,263,6131190,65.93,333,4475235,48.12,550,747902,8.04,63.04,7.7,29.26
2022-03-09T00:00:00.000Z,88,6705959,72.11,212,6131402,65.93,332,4475567,48.13,492,748394,8.05,63.02,7.72,29.25
2022-03-10T00:00:00.000Z,113,6706072,72.11,373,6131775,65.94,425,4475992,48.13,616,749010,8.05,63.01,7.74,29.25
2022-03-11T00:00:00.000Z,24,6706096,72.11,86,6131861,65.94,122,4476114,48.13,144,749154,8.06,63,7.75,29.25
2022-03-12T00:00:00.000Z,10,6706106,72.11,10,6131871,65.94,31,4476145,48.13,27,749181,8.06,62.98,7.77,29.24
2022-03-13T00:00:00.000Z,100,6706206,72.12,271,6132142,65.94,358,4476503,48.14,594,749775,8.06,62.98,7.78,29.24
2022-03-14T00:00:00.000Z,65,6706271,72.12,252,6132394,65.94,316,4476819,48.14,559,750334,8.07,62.98,7.78,29.24
2022-03-15T00:00:00.000Z,79,6706350,72.12,183,6132577,65.95,291,4477110,48.14,587,750921,8.08,62.95,7.81,29.24
2022-03-16T00:00:00.000Z,75,6706425,72.12,205,6132782,65.95,300,4477410,48.15,669,751590,8.08,62.94,7.82,29.24
2022-03-17T00:00:00.000Z,65,6706490,72.12,121,6132903,65.95,286,4477696,48.15,613,752203,8.09,62.94,7.82,29.24
2022-03-18T00:00:00.000Z,19,6706509,72.12,54,6132957,65.95,99,4477795,48.15,234,752437,8.09,62.94,7.82,29.24
2022-03-19T00:00:00.000Z,5,6706514,72.12,10,6132967,65.95,27,4477822,48.15,38,752475,8.09,62.89,7.88,29.23
2022-03-20T00:00:00.000Z,119,6706633,72.12,258,6133225,65.95,486,4478308,48.16,1428,753903,8.11,62.87,7.89,29.23
2022-03-21T00:00:00.000Z,97,6706730,72.12,246,6133471,65.96,374,4478682,48.16,1132,755035,8.12,62.87,7.9,29.23
2022-03-22T00:00:00.000Z,140,6706870,72.12,341,6133812,65.96,504,4479186,48.17,1769,756804,8.14,62.84,7.94,29.23
2022-03-23T00:00:00.000Z,109,6706979,72.12,210,6134022,65.96,461,4479647,48.17,1674,758478,8.16,62.81,7.97,29.22
2022-03-24T00:00:00.000Z,175,6707154,72.13,345,6134367,65.97,763,4480410,48.18,2359,760837,8.18,62.78,8,29.22
2022-03-25T00:00:00.000Z,38,6707192,72.13,79,6134446,65.97,156,4480566,48.18,628,761465,8.19,62.78,8,29.23
2022-03-26T00:00:00.000Z,12,6707204,72.13,11,6134457,65.97,33,4480599,48.18,91,761556,8.19,62.77,8,29.22
2022-03-27T00:00:00.000Z,165,6707369,72.13,343,6134800,65.97,757,4481356,48.19,3191,764747,8.22,62.75,8.02,29.22
2022-03-28T00:00:00.000Z,113,6707482,72.13,269,6135069,65.97,621,4481977,48.2,2414,767161,8.25,62.75,8.03,29.22
2022-03-29T00:00:00.000Z,125,6707607,72.13,257,6135326,65.98,640,4482617,48.2,2770,769931,8.28,62.7,8.07,29.22
2022-03-30T00:00:00.000Z,132,6707739,72.13,207,6135533,65.98,538,4483155,48.21,2369,772300,8.3,62.81,8.11,29.07
2022-03-31T00:00:00.000Z,166,6707905,72.13,301,6135834,65.98,729,4483884,48.22,2847,775147,8.34,62.79,8.11,29.1
2022-04-01T00:00:00.000Z,121,6708026,72.13,159,6135993,65.98,274,4484158,48.22,583,775730,8.34,62.72,8.13,29.15
2022-04-02T00:00:00.000Z,6,6708032,72.13,6,6135999,65.98,35,4484193,48.22,52,775782,8.34,62.69,8.15,29.16
2022-04-03T00:00:00.000Z,159,6708191,72.14,269,6136268,65.99,569,4484762,48.23,2474,778256,8.37,62.65,8.16,29.19
2022-04-04T00:00:00.000Z,103,6708294,72.14,206,6136474,65.99,482,4485244,48.23,2218,780474,8.39,62.62,8.16,29.22
2022-04-05T00:00:00.000Z,123,6708417,72.14,219,6136693,65.99,512,4485756,48.24,2241,782715,8.42,62.57,8.19,29.25
2022-04-06T00:00:00.000Z,92,6708509,72.14,155,6136848,65.99,380,4486136,48.24,2017,784732,8.44,62.55,8.2,29.25
2022-04-07T00:00:00.000Z,190,6708699,72.14,215,6137063,65.99,641,4486777,48.25,2553,787285,8.47,62.56,8.2,29.24
2022-04-08T00:00:00.000Z,30,6708729,72.14,60,6137123,66,151,4486928,48.25,477,787762,8.47,62.54,8.22,29.23
2022-04-09T00:00:00.000Z,6,6708735,72.14,17,6137140,66,26,4486954,48.25,46,787808,8.47,62.52,8.25,29.23
2022-04-10T00:00:00.000Z,102,6708837,72.14,264,6137404,66,429,4487383,48.26,1845,789653,8.49,62.51,8.26,29.23
2022-04-11T00:00:00.000Z,78,6708915,72.14,201,6137605,66,370,4487753,48.26,1425,791078,8.51,62.54,8.26,29.2
2022-04-12T00:00:00.000Z,204,6709119,72.15,168,6137773,66,372,4488125,48.26,1359,792437,8.52,62.58,8.29,29.12
2022-04-13T00:00:00.000Z,119,6709238,72.15,150,6137923,66,296,4488421,48.27,1215,793652,8.53,62.58,8.31,29.1
2022-04-14T00:00:00.000Z,84,6709322,72.15,221,6138144,66.01,320,4488741,48.27,1068,794720,8.55,62.57,8.33,29.1
2022-04-15T00:00:00.000Z,9,6709331,72.15,51,6138195,66.01,47,4488788,48.27,80,794800,8.55,62.55,8.35,29.1
2022-04-16T00:00:00.000Z,3,6709334,72.15,8,6138203,66.01,21,4488809,48.27,29,794829,8.55,62.53,8.37,29.1
2022-04-17T00:00:00.000Z,62,6709396,72.15,131,6138334,66.01,228,4489037,48.27,807,795636,8.56,62.52,8.38,29.1
2022-04-18T00:00:00.000Z,69,6709465,72.15,107,6138441,66.01,251,4489288,48.28,749,796385,8.56,62.51,8.38,29.1
2022-04-19T00:00:00.000Z,60,6709525,72.15,143,6138584,66.01,272,4489560,48.28,840,797225,8.57,62.5,8.4,29.1
2022-04-20T00:00:00.000Z,60,6709585,72.15,117,6138701,66.01,235,4489795,48.28,651,797876,8.58,62.48,8.42,29.1
2022-04-21T00:00:00.000Z,52,6709637,72.15,107,6138808,66.01,193,4489988,48.28,479,798355,8.59,62.47,8.43,29.1
2022-04-22T00:00:00.000Z,2,6709639,72.15,16,6138824,66.01,18,4490006,48.28,16,798371,8.59,62.45,8.44,29.11
2022-04-23T00:00:00.000Z,6,6709645,72.15,9,6138833,66.01,14,4490020,48.28,13,798384,8.59,62.43,8.46,29.11
2022-04-24T00:00:00.000Z,92,6709737,72.15,250,6139083,66.02,329,4490349,48.29,870,799254,8.59,62.43,8.47,29.1
2022-04-25T00:00:00.000Z,105,6709842,72.15,191,6139274,66.02,315,4490664,48.29,738,799992,8.6,62.43,8.47,29.1
2022-04-26T00:00:00.000Z,75,6709917,72.16,175,6139449,66.02,302,4490966,48.29,786,800778,8.61,62.42,8.48,29.1
2022-04-27T00:00:00.000Z,55,6709972,72.16,160,6139609,66.02,227,4491193,48.3,638,801416,8.62,62.41,8.49,29.1
2022-04-28T00:00:00.000Z,96,6710068,72.16,232,6139841,66.02,326,4491519,48.3,869,802285,8.63,62.41,8.5,29.1
2022-04-29T00:00:00.000Z,108,6710176,72.16,158,6139999,66.03,182,4491701,48.3,196,802481,8.63,62.39,8.51,29.1
2022-04-30T00:00:00.000Z,1,6710177,72.16,3,6140002,66.03,24,4491725,48.3,20,802501,8.63,62.38,8.52,29.1
2022-05-01T00:00:00.000Z,135,6710312,72.16,185,6140187,66.03,316,4492041,48.31,630,803131,8.64,62.38,8.53,29.09
2022-05-02T00:00:00.000Z,62,6710374,72.16,152,6140339,66.03,235,4492276,48.31,489,803620,8.64,62.37,8.54,29.09
2022-05-03T00:00:00.000Z,72,6710446,72.16,151,6140490,66.03,287,4492563,48.31,505,804125,8.65,62.36,8.55,29.09
2022-05-04T00:00:00.000Z,23,6710469,72.16,55,6140545,66.03,63,4492626,48.31,125,804250,8.65,62.35,8.57,29.08
2022-05-05T00:00:00.000Z,4,6710473,72.16,1,6140546,66.03,5,4492631,48.31,11,804261,8.65,62.34,8.58,29.08
2022-05-06T00:00:00.000Z,19,6710492,72.16,59,6140605,66.03,64,4492695,48.31,151,804412,8.65,62.33,8.59,29.08
2022-05-07T00:00:00.000Z,0,6710492,72.16,6,6140611,66.03,25,4492720,48.31,24,804436,8.65,62.32,8.6,29.08
2022-05-08T00:00:00.000Z,118,6710610,72.16,207,6140818,66.04,270,4492990,48.32,456,804892,8.66,62.31,8.61,29.08
2022-05-09T00:00:00.000Z,59,6710669,72.16,162,6140980,66.04,251,4493241,48.32,503,805395,8.66,62.31,8.61,29.08
2022-05-10T00:00:00.000Z,131,6710800,72.16,168,6141148,66.04,260,4493501,48.32,508,805903,8.67,62.3,8.62,29.08
2022-05-11T00:00:00.000Z,58,6710858,72.17,116,6141264,66.04,179,4493680,48.32,463,806366,8.67,62.3,8.63,29.08
2022-05-12T00:00:00.000Z,118,6710976,72.17,200,6141464,66.04,275,4493955,48.33,663,807029,8.68,62.29,8.64,29.07
2022-05-13T00:00:00.000Z,11,6710987,72.17,42,6141506,66.04,70,4494025,48.33,108,807137,8.68,62.28,8.65,29.07
2022-05-14T00:00:00.000Z,6,6710993,72.17,12,6141518,66.04,10,4494035,48.33,22,807159,8.68,62.26,8.66,29.07
2022-05-15T00:00:00.000Z,91,6711084,72.17,175,6141693,66.04,241,4494276,48.33,663,807822,8.69,62.26,8.67,29.07
2022-05-16T00:00:00.000Z,68,6711152,72.17,142,6141835,66.05,229,4494505,48.33,508,808330,8.69,62.19,8.65,29.16
2022-05-17T00:00:00.000Z,73,6711225,72.17,155,6141990,66.05,265,4494770,48.33,616,808946,8.7,62.18,8.66,29.16
2022-05-18T00:00:00.000Z,43,6711268,72.17,98,6142088,66.05,169,4494939,48.34,445,809391,8.7,62.17,8.67,29.16
2022-05-19T00:00:00.000Z,64,6711332,72.17,170,6142258,66.05,211,4495150,48.34,498,809889,8.71,62.16,8.68,29.16
2022-05-20T00:00:00.000Z,72,6711404,72.17,112,6142370,66.05,127,4495277,48.34,138,810027,8.71,62.15,8.69,29.16
2022-05-21T00:00:00.000Z,4,6711408,72.17,7,6142377,66.05,13,4495290,48.34,18,810045,8.71,62.14,8.7,29.16
2022-05-22T00:00:00.000Z,87,6711495,72.17,188,6142565,66.05,216,4495506,48.34,425,810470,8.72,62.14,8.71,29.16
2022-05-23T00:00:00.000Z,64,6711559,72.17,120,6142685,66.06,154,4495660,48.34,343,810813,8.72,62.14,8.71,29.16
2022-05-24T00:00:00.000Z,43,6711602,72.17,119,6142804,66.06,155,4495815,48.35,393,811206,8.72,62.13,8.71,29.15
2022-05-25T00:00:00.000Z,61,6711663,72.17,103,6142907,66.06,165,4495980,48.35,337,811543,8.73,62.12,8.72,29.15
2022-05-26T00:00:00.000Z,72,6711735,72.17,136,6143043,66.06,184,4496164,48.35,348,811891,8.73,62.11,8.73,29.16
2022-05-27T00:00:00.000Z,11,6711746,72.17,28,6143071,66.06,43,4496207,48.35,59,811950,8.73,62.1,8.74,29.16
2022-05-28T00:00:00.000Z,1,6711747,72.17,4,6143075,66.06,7,4496214,48.35,12,811962,8.73,62.09,8.75,29.16
2022-05-29T00:00:00.000Z,89,6711836,72.18,152,6143227,66.06,163,4496377,48.35,314,812276,8.73,62.09,8.75,29.16
2022-05-30T00:00:00.000Z,56,6711892,72.18,132,6143359,66.06,124,4496501,48.35,291,812567,8.74,62.09,8.76,29.16
2022-05-31T00:00:00.000Z,45,6711937,72.18,104,6143463,66.06,153,4496654,48.35,350,812917,8.74,62.07,8.78,29.15
2022-06-01T00:00:00.000Z,63,6712000,72.18,89,6143552,66.06,117,4496771,48.36,274,813191,8.74,61.95,8.9,29.16
2022-06-02T00:00:00.000Z,76,6712076,72.18,156,6143708,66.07,174,4496945,48.36,254,813445,8.75,45.96,24.88,29.15
2022-06-03T00:00:00.000Z,10,6712086,72.18,23,6143731,66.07,21,4496966,48.36,32,813477,8.75,45.9,24.95,29.16
2022-06-04T00:00:00.000Z,0,6712086,72.18,7,6143738,66.07,7,4496973,48.36,5,813482,8.75,45.84,25,29.16
2022-06-05T00:00:00.000Z,11,6712097,72.18,14,6143752,66.07,6,4496979,48.36,2,813484,8.75,45.8,25.05,29.16
2022-06-06T00:00:00.000Z,58,6712155,72.18,144,6143896,66.07,161,4497140,48.36,262,813746,8.75,39.96,30.89,29.16
2022-06-07T00:00:00.000Z,54,6712209,72.18,133,6144029,66.07,141,4497281,48.36,375,814121,8.75,39.92,30.93,29.15
2022-06-08T00:00:00.000Z,57,6712266,72.18,105,6144134,66.07,130,4497411,48.36,495,814616,8.76,39.89,30.96,29.15
2022-06-09T00:00:00.000Z,84,6712350,72.18,206,6144340,66.07,234,4497645,48.37,641,815257,8.77,39.86,30.99,29.15
2022-06-10T00:00:00.000Z,14,6712364,72.18,51,6144391,66.07,59,4497704,48.37,138,815395,8.77,39.83,31.02,29.15
2022-06-11T00:00:00.000Z,0,6712364,72.18,3,6144394,66.07,7,4497711,48.37,19,815414,8.77,39.8,31.05,29.15
2022-06-12T00:00:00.000Z,108,6712472,72.18,199,6144593,66.08,191,4497902,48.37,767,816181,8.78,39.8,31.05,29.15
2022-06-13T00:00:00.000Z,81,6712553,72.18,142,6144735,66.08,166,4498068,48.37,625,816806,8.78,39.81,31.04,29.15
2022-06-14T00:00:00.000Z,116,6712669,72.18,172,6144907,66.08,208,4498276,48.37,759,817565,8.79,39.79,31.06,29.15
2022-06-15T00:00:00.000Z,72,6712741,72.19,141,6145048,66.08,207,4498483,48.37,696,818261,8.8,39.78,31.08,29.15
2022-06-16T00:00:00.000Z,92,6712833,72.19,136,6145184,66.08,217,4498700,48.38,740,819001,8.81,39.74,31.11,29.14
2022-06-17T00:00:00.000Z,16,6712849,72.19,63,6145247,66.08,52,4498752,48.38,122,819123,8.81,39.72,31.14,29.15
2022-06-18T00:00:00.000Z,3,6712852,72.19,4,6145251,66.08,11,4498763,48.38,15,819138,8.81,39.68,31.17,29.14
2022-06-19T00:00:00.000Z,115,6712967,72.19,207,6145458,66.09,317,4499080,48.38,877,820015,8.82,39.53,31.33,29.15
2022-06-20T00:00:00.000Z,99,6713066,72.19,152,6145610,66.09,306,4499386,48.38,922,820937,8.83,33.92,36.85,29.23
2022-06-21T00:00:00.000Z,94,6713160,72.19,155,6145765,66.09,375,4499761,48.39,1228,822165,8.84,33.58,37.19,29.23
2022-06-22T00:00:00.000Z,110,6713270,72.19,133,6145898,66.09,339,4500100,48.39,894,823059,8.85,33.28,37.49,29.23
2022-06-23T00:00:00.000Z,133,6713403,72.19,216,6146114,66.09,524,4500624,48.4,1146,824205,8.86,32.84,37.92,29.23
2022-06-24T00:00:00.000Z,19,6713422,72.19,35,6146149,66.09,109,4500733,48.4,207,824412,8.87,32.43,38.34,29.24
2022-06-25T00:00:00.000Z,1,6713423,72.19,1,6146150,66.09,12,4500745,48.4,16,824428,8.87,32.04,38.72,29.24
2022-06-26T00:00:00.000Z,107,6713530,72.19,158,6146308,66.09,379,4501124,48.4,933,825361,8.88,31.63,39.13,29.24
2022-06-27T00:00:00.000Z,85,6713615,72.19,172,6146480,66.1,391,4501515,48.41,1027,826388,8.89,31.29,39.47,29.24
2022-06-28T00:00:00.000Z,84,6713699,72.2,151,6146631,66.1,362,4501877,48.41,930,827318,8.9,30.86,39.91,29.24
2022-06-29T00:00:00.000Z,77,6713776,72.2,106,6146737,66.1,262,4502139,48.41,813,828131,8.91,30.48,40.28,29.24
2022-06-30T00:00:00.000Z,84,6713860,72.2,164,6146901,66.1,355,4502494,48.42,1058,829189,8.92,30.05,40.71,29.24
2022-07-01T00:00:00.000Z,21,6713881,72.2,28,6146929,66.1,54,4502548,48.42,77,829266,8.92,29.62,41.14,29.24
2022-07-02T00:00:00.000Z,0,6713881,72.2,2,6146931,66.1,6,4502554,48.42,18,829284,8.92,29.2,41.56,29.24
2022-07-03T00:00:00.000Z,88,6713969,72.2,177,6147108,66.1,318,4502872,48.42,637,829921,8.92,28.81,41.95,29.24
2022-07-04T00:00:00.000Z,76,6714045,72.2,140,6147248,66.1,275,4503147,48.42,747,830668,8.93,28.5,42.26,29.24
2022-07-05T00:00:00.000Z,58,6714103,72.2,142,6147390,66.11,301,4503448,48.43,688,831356,8.94,28.06,42.7,29.24
2022-07-06T00:00:00.000Z,78,6714181,72.2,125,6147515,66.11,211,4503659,48.43,643,831999,8.95,27.39,43.37,29.24
2022-07-07T00:00:00.000Z,81,6714262,72.2,163,6147678,66.11,266,4503925,48.43,722,832721,8.95,26.48,44.28,29.24
2022-07-08T00:00:00.000Z,17,6714279,72.2,33,6147711,66.11,68,4503993,48.43,131,832852,8.96,25.47,45.29,29.24
2022-07-09T00:00:00.000Z,0,6714279,72.2,1,6147712,66.11,1,4503994,48.43,1,832853,8.96,24.42,46.34,29.24
2022-07-10T00:00:00.000Z,87,6714366,72.2,164,6147876,66.11,230,4504224,48.44,469,833322,8.96,23.77,46.99,29.24
2022-07-11T00:00:00.000Z,64,6714430,72.2,140,6148016,66.11,245,4504469,48.44,571,833893,8.97,23.22,47.54,29.24
2022-07-12T00:00:00.000Z,69,6714499,72.2,128,6148144,66.11,207,4504676,48.44,556,834449,8.97,22.13,48.63,29.24
2022-07-13T00:00:00.000Z,43,6714542,72.2,100,6148244,66.12,163,4504839,48.44,488,834937,8.98,21.1,49.66,29.24
2022-07-14T00:00:00.000Z,69,6714611,72.21,147,6148391,66.12,208,4505047,48.45,511,835448,8.98,20.12,50.63,29.24
2022-07-15T00:00:00.000Z,57,6714668,72.21,83,6148474,66.12,129,4505176,48.45,166,835614,8.99,19.27,51.48,29.25
2022-07-16T00:00:00.000Z,0,6714668,72.21,6,6148480,66.12,7,4505183,48.45,7,835621,8.99,18.29,52.46,29.25
2022-07-17T00:00:00.000Z,75,6714743,72.21,182,6148662,66.12,241,4505424,48.45,468,836089,8.99,17.83,52.92,29.25
2022-07-18T00:00:00.000Z,62,6714805,72.21,157,6148819,66.12,206,4505630,48.45,510,836599,9,17.48,53.26,29.26
2022-07-19T00:00:00.000Z,61,6714866,72.21,146,6148965,66.12,173,4505803,48.45,368,836967,9,16.77,53.97,29.26
2022-07-20T00:00:00.000Z,52,6714918,72.21,133,6149098,66.12,136,4505939,48.45,421,837388,9,16.09,54.64,29.26
2022-07-21T00:00:00.000Z,63,6714981,72.21,155,6149253,66.13,175,4506114,48.46,340,837728,9.01,15.43,55.3,29.27
2022-07-22T00:00:00.000Z,10,6714991,72.21,36,6149289,66.13,41,4506155,48.46,56,837784,9.01,14.64,56.08,29.28
2022-07-23T00:00:00.000Z,0,6714991,72.21,3,6149292,66.13,4,4506159,48.46,9,837793,9.01,14.17,56.55,29.28
2022-07-24T00:00:00.000Z,58,6715049,72.21,126,6149418,66.13,196,4506355,48.46,363,838156,9.01,13.55,57.16,29.29
2022-07-25T00:00:00.000Z,48,6715097,72.21,107,6149525,66.13,170,4506525,48.46,335,838491,9.02,13.09,57.61,29.3
2022-07-26T00:00:00.000Z,47,6715144,72.21,100,6149625,66.13,109,4506634,48.46,270,838761,9.02,12.46,58.23,29.3
2022-07-27T00:00:00.000Z,44,6715188,72.21,125,6149750,66.13,131,4506765,48.46,242,839003,9.02,11.89,58.8,29.31
2022-07-28T00:00:00.000Z,62,6715250,72.21,140,6149890,66.13,147,4506912,48.47,219,839222,9.02,11.35,59.34,29.31
2022-07-29T00:00:00.000Z,10,6715260,72.21,25,6149915,66.13,27,4506939,48.47,30,839252,9.02,10.85,59.83,29.32
2022-07-30T00:00:00.000Z,0,6715260,72.21,0,6149915,66.13,1,4506940,48.47,1,839253,9.02,10.34,60.33,29.33
2022-07-31T00:00:00.000Z,58,6715318,72.21,133,6150048,66.13,131,4507071,48.47,252,839505,9.03,9.97,60.7,29.33
2022-08-01T00:00:00.000Z,54,6715372,72.21,75,6150123,66.14,88,4507159,48.47,152,839657,9.03,9.47,61.19,29.34
2022-08-02T00:00:00.000Z,111,6715483,72.21,119,6150242,66.14,155,4507314,48.47,264,839921,9.03,8.92,61.73,29.35
2022-08-03T00:00:00.000Z,76,6715559,72.22,70,6150312,66.14,92,4507406,48.47,177,840098,9.03,8.46,62.19,29.35
2022-08-04T00:00:00.000Z,126,6715685,72.22,133,6150445,66.14,111,4507517,48.47,244,840342,9.04,8.04,62.61,29.36
2022-08-05T00:00:00.000Z,30,6715715,72.22,22,6150467,66.14,13,4507530,48.47,23,840365,9.04,7.71,62.93,29.36
2022-08-06T00:00:00.000Z,1,6715716,72.22,2,6150469,66.14,1,4507531,48.47,5,840370,9.04,7.32,63.32,29.36
2022-08-07T00:00:00.000Z,76,6715792,72.22,82,6150551,66.14,66,4507597,48.47,168,840538,9.04,6.92,63.71,29.37
2022-08-08T00:00:00.000Z,76,6715868,72.22,92,6150643,66.14,122,4507719,48.47,171,840709,9.04,6.74,63.89,29.37
2022-08-09T00:00:00.000Z,96,6715964,72.22,87,6150730,66.14,99,4507818,48.47,213,840922,9.04,6.25,64.37,29.38
2022-08-10T00:00:00.000Z,76,6716040,72.22,58,6150788,66.14,75,4507893,48.48,115,841037,9.04,5.91,64.71,29.38
2022-08-11T00:00:00.000Z,53,6716093,72.22,101,6150889,66.14,91,4507984,48.48,154,841191,9.05,5.59,65.03,29.38
2022-08-12T00:00:00.000Z,8,6716101,72.22,12,6150901,66.14,17,4508001,48.48,27,841218,9.05,5.35,65.27,29.38
2022-08-13T00:00:00.000Z,0,6716101,72.22,1,6150902,66.14,2,4508003,48.48,3,841221,9.05,5.1,65.52,29.38
2022-08-14T00:00:00.000Z,73,6716174,72.22,75,6150977,66.14,82,4508085,48.48,150,841371,9.05,4.87,65.75,29.39
2022-08-15T00:00:00.000Z,68,6716242,72.22,81,6151058,66.15,93,4508178,48.48,142,841513,9.05,4.74,65.87,29.39
2022-08-16T00:00:00.000Z,81,6716323,72.22,84,6151142,66.15,83,4508261,48.48,186,841699,9.05,4.46,66.15,29.39
2022-08-17T00:00:00.000Z,48,6716371,72.22,55,6151197,66.15,36,4508297,48.48,114,841813,9.05,4.16,66.44,29.39
2022-08-18T00:00:00.000Z,64,6716435,72.23,93,6151290,66.15,119,4508416,48.48,173,841986,9.05,3.98,66.63,29.39
2022-08-19T00:00:00.000Z,73,6716508,72.23,55,6151345,66.15,55,4508471,48.48,45,842031,9.05,3.83,66.78,29.39
2022-08-20T00:00:00.000Z,1,6716509,72.23,1,6151346,66.15,3,4508474,48.48,3,842034,9.05,3.67,66.94,29.39
2022-08-21T00:00:00.000Z,50,6716559,72.23,86,6151432,66.15,84,4508558,48.48,193,842227,9.06,3.52,67.08,29.4
2022-08-22T00:00:00.000Z,89,6716648,72.23,74,6151506,66.15,102,4508660,48.48,142,842369,9.06,3.44,67.16,29.4
2022-08-23T00:00:00.000Z,73,6716721,72.23,106,6151612,66.15,83,4508743,48.48,178,842547,9.06,3.27,67.33,29.4
2022-08-24T00:00:00.000Z,38,6716759,72.23,80,6151692,66.15,48,4508791,48.49,132,842679,9.06,3.15,67.46,29.4
2022-08-25T00:00:00.000Z,54,6716813,72.23,75,6151767,66.15,91,4508882,48.49,192,842871,9.06,3.03,67.57,29.4
2022-08-26T00:00:00.000Z,4,6716817,72.23,15,6151782,66.15,9,4508891,48.49,14,842885,9.06,2.94,67.66,29.4
2022-08-27T00:00:00.000Z,0,6716817,72.23,0,6151782,66.15,0,4508891,48.49,0,842885,9.06,2.84,67.76,29.4
2022-08-28T00:00:00.000Z,55,6716872,72.23,79,6151861,66.15,84,4508975,48.49,101,842986,9.07,2.75,67.85,29.4
2022-08-29T00:00:00.000Z,48,6716920,72.23,68,6151929,66.15,89,4509064,48.49,107,843093,9.07,2.69,67.91,29.4
2022-08-30T00:00:00.000Z,88,6717008,72.23,110,6152039,66.16,83,4509147,48.49,128,843221,9.07,2.6,68,29.4
2022-08-31T00:00:00.000Z,44,6717052,72.23,86,6152125,66.16,69,4509216,48.49,91,843312,9.07,2.53,68.07,29.4
2022-09-01T00:00:00.000Z,27,6717079,72.23,84,6152209,66.16,57,4509273,48.49,108,843420,9.07,2.46,68.14,29.4
2022-09-02T00:00:00.000Z,6,6717085,72.23,20,6152229,66.16,13,4509286,48.49,9,843429,9.07,2.4,68.2,29.4
2022-09-03T00:00:00.000Z,2,6717087,72.23,0,6152229,66.16,3,4509289,48.49,1,843430,9.07,2.33,68.27,29.4
2022-09-04T00:00:00.000Z,50,6717137,72.23,118,6152347,66.16,78,4509367,48.49,118,843548,9.07,2.27,68.32,29.4
2022-09-05T00:00:00.000Z,43,6717180,72.23,77,6152424,66.16,57,4509424,48.49,87,843635,9.07,2.23,68.37,29.4
2022-09-06T00:00:00.000Z,59,6717239,72.23,104,6152528,66.16,77,4509501,48.49,124,843759,9.07,2.17,68.42,29.4
2022-09-07T00:00:00.000Z,12,6717251,72.23,19,6152547,66.16,20,4509521,48.49,38,843797,9.07,2.12,68.47,29.4
