Day_Date,vaccinated,vaccinated_cum,vaccinated_population_perc,vaccinated_seconde_dose,vaccinated_seconde_dose_cum,vaccinated_seconde_dose_population_perc,vaccinated_third_dose,vaccinated_third_dose_cum,vaccinated_third_dose_population_perc,vaccinated_fourth_dose,vaccinated_fourth_dose_cum,vaccinated_fourth_dose_population_perc,vaccinated_validity_perc,vaccinated_expired_perc,not_vaccinated_perc
2020-12-19T00:00:00.000Z,46,66,0,0,4,0,0,0,0,0,0,0,0,0,100
2020-12-20T00:00:00.000Z,7390,7456,0.08,0,4,0,0,0,0,0,0,0,0,0,100
2020-12-21T00:00:00.000Z,24917,32373,0.35,0,4,0,0,0,0,0,0,0,0,0,100
2020-12-22T00:00:00.000Z,44653,77026,0.83,0,4,0,0,0,0,0,0,0,0,0,100
2020-12-23T00:00:00.000Z,62900,139926,1.5,0,4,0,0,0,0,0,0,0,0,0,100
2020-12-24T00:00:00.000Z,73411,213337,2.29,0,4,0,0,0,0,0,0,0,0,0,100
2020-12-25T00:00:00.000Z,38505,251842,2.71,0,4,0,0,0,0,0,0,0,0,0,100
2020-12-26T00:00:00.000Z,32609,284451,3.06,0,4,0,0,0,0,0,0,0,0,0,100
2020-12-27T00:00:00.000Z,104543,388994,4.18,0,4,0,0,0,0,0,0,0,0,0,100
2020-12-28T00:00:00.000Z,134990,523984,5.63,0,4,0,0,0,0,0,0,0,0,0,100
2020-12-29T00:00:00.000Z,156258,680242,7.32,2,6,0,0,0,0,0,0,0,0,0,100
2020-12-30T00:00:00.000Z,153106,833348,8.96,0,6,0,0,0,0,0,0,0,0,0,100
2020-12-31T00:00:00.000Z,158512,991860,10.67,0,6,0,0,0,0,0,0,0,0,0,100
2021-01-01T00:00:00.000Z,71403,1063263,11.43,0,6,0,0,0,0,0,0,0,0,0,100
2021-01-02T00:00:00.000Z,71709,1134972,12.2,0,6,0,0,0,0,0,0,0,0,0,100
2021-01-03T00:00:00.000Z,149697,1284669,13.81,0,6,0,0,0,0,0,0,0,0,0,100
2021-01-04T00:00:00.000Z,152142,1436811,15.45,1,7,0,0,0,0,0,0,0,0,0,100
2021-01-05T00:00:00.000Z,125139,1561950,16.8,3,10,0,0,0,0,0,0,0,0,0,100
2021-01-06T00:00:00.000Z,103293,1665243,17.91,2,12,0,0,0,0,0,0,0,0,0,100
2021-01-07T00:00:00.000Z,115992,1781235,19.15,7,19,0,0,0,0,0,0,0,0,0,100
2021-01-08T00:00:00.000Z,66421,1847656,19.87,4,23,0,0,0,0,0,0,0,0,0,100
2021-01-09T00:00:00.000Z,44518,1892174,20.35,24,47,0,0,0,0,0,0,0,0,0,100
2021-01-10T00:00:00.000Z,37629,1929803,20.75,5997,6044,0.07,0,0,0,0,0,0,0,0,100
2021-01-11T00:00:00.000Z,21144,1950947,20.98,19259,25303,0.27,0,0,0,0,0,0,0,0,100
2021-01-12T00:00:00.000Z,24038,1974985,21.24,35666,60969,0.66,0,0,0,0,0,0,0,0,100
2021-01-13T00:00:00.000Z,52032,2027017,21.8,56861,117830,1.27,0,0,0,0,0,0,0,0,100
2021-01-14T00:00:00.000Z,56427,2083444,22.4,68825,186655,2.01,0,0,0,0,0,0,0,0,100
2021-01-15T00:00:00.000Z,30743,2114187,22.73,35927,222582,2.39,0,0,0,0,0,0,0,0,100
2021-01-16T00:00:00.000Z,29451,2143638,23.05,26004,248586,2.67,0,0,0,0,0,0,0,0,100
2021-01-17T00:00:00.000Z,68405,2212043,23.79,84579,333165,3.58,0,0,0,0,0,0,0.36,0,99.64
2021-01-18T00:00:00.000Z,69760,2281803,24.54,120401,453566,4.88,0,0,0,0,0,0,0.64,0,99.36
2021-01-19T00:00:00.000Z,72848,2354651,25.32,137807,591373,6.36,0,0,0,0,0,0,1.16,0,98.84
2021-01-20T00:00:00.000Z,76855,2431506,26.15,143717,735090,7.9,0,0,0,0,0,0,1.98,0,98.02
2021-01-21T00:00:00.000Z,69956,2501462,26.9,164395,899485,9.67,0,0,0,0,0,0,2.98,0,97.02
2021-01-22T00:00:00.000Z,37890,2539352,27.31,71110,970595,10.44,0,0,0,0,0,0,3.5,0,96.5
2021-01-23T00:00:00.000Z,39948,2579300,27.74,53568,1024163,11.01,0,0,0,0,0,0,3.89,0,96.11
2021-01-24T00:00:00.000Z,69098,2648398,28.48,140662,1164825,12.53,0,0,0,0,0,0,5.1,0,94.9
2021-01-25T00:00:00.000Z,80893,2729291,29.35,139478,1304303,14.03,0,0,0,0,0,0,6.78,0,93.22
2021-01-26T00:00:00.000Z,78682,2807973,30.2,126386,1430689,15.38,0,0,0,0,0,0,8.65,0,91.35
2021-01-27T00:00:00.000Z,77929,2885902,31.03,125019,1555708,16.73,0,0,0,0,0,0,10.56,0,89.44
2021-01-28T00:00:00.000Z,79531,2965433,31.89,130575,1686283,18.13,0,0,0,0,0,0,12.69,0,87.31
2021-01-29T00:00:00.000Z,36667,3002100,32.28,64767,1751050,18.83,0,0,0,0,0,0,13.61,0,86.39
2021-01-30T00:00:00.000Z,34383,3036483,32.65,42748,1793798,19.29,0,0,0,0,0,0,14.3,0,85.7
2021-01-31T00:00:00.000Z,73310,3109793,33.44,59479,1853277,19.93,0,0,0,0,0,0,16.07,0,83.93
2021-02-01T00:00:00.000Z,82466,3192259,34.33,35326,1888603,20.31,0,0,0,0,0,0,17.81,0,82.19
2021-02-02T00:00:00.000Z,70058,3262317,35.08,31048,1919651,20.64,0,0,0,0,0,0,19.35,0,80.65
2021-02-03T00:00:00.000Z,60272,3322589,35.73,51412,1971063,21.2,0,0,0,0,0,0,20.84,0,79.16
2021-02-04T00:00:00.000Z,72594,3395183,36.51,58066,2029129,21.82,0,0,0,0,0,0,22.39,0,77.61
2021-02-05T00:00:00.000Z,33910,3429093,36.87,28781,2057910,22.13,0,0,0,0,0,0,23.15,0,76.85
2021-02-06T00:00:00.000Z,21600,3450693,37.11,22221,2080131,22.37,0,0,0,0,0,0,23.64,0,76.36
2021-02-07T00:00:00.000Z,54064,3504757,37.69,68708,2148839,23.11,0,0,0,0,0,0,24.4,0,75.6
2021-02-08T00:00:00.000Z,58609,3563366,38.32,65438,2214277,23.81,0,0,0,0,0,0,24.95,0,75.05
2021-02-09T00:00:00.000Z,66309,3629675,39.03,67536,2281813,24.54,0,0,0,0,0,0,25.48,0,74.52
2021-02-10T00:00:00.000Z,70526,3700201,39.79,72273,2354086,25.31,0,0,0,0,0,0,26.23,0,73.77
2021-02-11T00:00:00.000Z,81137,3781338,40.66,72073,2426159,26.09,0,0,0,0,0,0,27.08,0,72.92
2021-02-12T00:00:00.000Z,39078,3820416,41.08,37562,2463721,26.49,0,0,0,0,0,0,27.5,0,72.5
2021-02-13T00:00:00.000Z,27448,3847864,41.38,30423,2494144,26.82,0,0,0,0,0,0,27.82,0,72.18
2021-02-14T00:00:00.000Z,74883,3922747,42.18,69054,2563198,27.56,0,0,0,0,0,0,28.76,0,71.24
2021-02-15T00:00:00.000Z,81510,4004257,43.06,75674,2638872,28.38,0,0,0,0,0,0,29.69,0,70.31
2021-02-16T00:00:00.000Z,83392,4087649,43.96,78253,2717125,29.22,0,0,0,0,0,0,30.64,0,69.36
2021-02-17T00:00:00.000Z,61951,4149600,44.62,75600,2792725,30.03,0,0,0,0,0,0,31.56,0,68.44
2021-02-18T00:00:00.000Z,69124,4218724,45.37,79711,2872436,30.89,0,0,0,0,0,0,32.51,0,67.49
2021-02-19T00:00:00.000Z,39647,4258371,45.79,38129,2910565,31.3,0,0,0,0,0,0,33.02,0,66.98
2021-02-20T00:00:00.000Z,31643,4290014,46.13,28716,2939281,31.61,0,0,0,0,0,0,33.43,0,66.57
2021-02-21T00:00:00.000Z,79411,4369425,46.99,78422,3017703,32.45,0,0,0,0,0,0,34.39,0,65.61
2021-02-22T00:00:00.000Z,85031,4454456,47.9,80574,3098277,33.32,0,0,0,0,0,0,35.44,0,64.56
2021-02-23T00:00:00.000Z,77305,4531761,48.73,70450,3168727,34.07,0,0,0,0,0,0,36.47,0,63.53
2021-02-24T00:00:00.000Z,61036,4592797,49.39,63105,3231832,34.75,0,0,0,0,0,0,37.4,0,62.6
2021-02-25T00:00:00.000Z,51698,4644495,49.94,64777,3296609,35.45,0,0,0,0,0,0,38.31,0,61.69
2021-02-26T00:00:00.000Z,25887,4670382,50.22,32014,3328623,35.79,0,0,0,0,0,0,38.76,0,61.24
2021-02-27T00:00:00.000Z,18333,4688715,50.42,21186,3349809,36.02,0,0,0,0,0,0,39.08,0,60.92
2021-02-28T00:00:00.000Z,40335,4729050,50.85,55858,3405667,36.62,0,0,0,0,0,0,39.92,0,60.08
2021-03-01T00:00:00.000Z,45710,4774760,51.35,61413,3467080,37.28,0,0,0,0,0,0,40.78,0,59.22
2021-03-02T00:00:00.000Z,41155,4815915,51.79,64762,3531842,37.98,0,0,0,0,0,0,41.54,0,58.46
2021-03-03T00:00:00.000Z,41992,4857907,52.24,66750,3598592,38.7,0,0,0,0,0,0,42.25,0,57.75
2021-03-04T00:00:00.000Z,39680,4897587,52.67,79095,3677687,39.55,0,0,0,0,0,0,42.95,0,57.05
2021-03-05T00:00:00.000Z,17329,4914916,52.85,40446,3718133,39.98,0,0,0,0,0,0,43.28,0,56.72
2021-03-06T00:00:00.000Z,10696,4925612,52.97,25337,3743470,40.26,0,0,0,0,0,0,43.5,0,56.5
2021-03-07T00:00:00.000Z,31125,4956737,53.3,72821,3816291,41.04,0,0,0,0,0,0,44.09,0,55.91
2021-03-08T00:00:00.000Z,27346,4984083,53.6,73264,3889555,41.83,0,0,0,0,0,0,44.71,0,55.29
2021-03-09T00:00:00.000Z,26716,5010799,53.88,76578,3966133,42.65,0,0,0,0,0,0,45.37,0,54.63
2021-03-10T00:00:00.000Z,23319,5034118,54.13,58653,4024786,43.28,0,0,0,0,0,0,46.03,0,53.97
2021-03-11T00:00:00.000Z,23271,5057389,54.38,69065,4093851,44.02,0,0,0,0,0,0,46.76,0,53.24
2021-03-12T00:00:00.000Z,11247,5068636,54.51,41395,4135246,44.47,0,0,0,0,0,0,47.12,0,52.88
2021-03-13T00:00:00.000Z,7925,5076561,54.59,25233,4160479,44.74,0,0,0,0,0,0,47.35,0,52.65
2021-03-14T00:00:00.000Z,20950,5097511,54.82,73922,4234401,45.53,0,0,0,0,0,0,47.99,0,52.01
2021-03-15T00:00:00.000Z,20110,5117621,55.03,78250,4312651,46.38,0,0,0,0,0,0,48.61,0,51.39
2021-03-16T00:00:00.000Z,18721,5136342,55.23,71454,4384105,47.14,0,0,0,0,0,0,49.23,0,50.77
2021-03-17T00:00:00.000Z,17664,5154006,55.42,58983,4443088,47.78,0,0,0,0,0,0,49.72,0,50.28
2021-03-18T00:00:00.000Z,16013,5170019,55.6,58107,4501195,48.4,0,0,0,0,0,0,50.26,0,49.74
2021-03-19T00:00:00.000Z,6919,5176938,55.67,27964,4529159,48.7,0,0,0,0,0,0,50.56,0,49.44
2021-03-20T00:00:00.000Z,5205,5182143,55.73,15287,4544446,48.87,0,0,0,0,0,0,50.74,0,49.26
2021-03-21T00:00:00.000Z,13142,5195285,55.87,40481,4584927,49.3,0,0,0,0,0,0,51.27,0,48.73
2021-03-22T00:00:00.000Z,13545,5208830,56.01,40513,4625440,49.74,0,0,0,0,0,0,51.81,0,48.19
2021-03-23T00:00:00.000Z,2807,5211637,56.04,7276,4632716,49.82,0,0,0,0,0,0,52.24,0,47.76
2021-03-24T00:00:00.000Z,10980,5222617,56.16,46527,4679243,50.32,0,0,0,0,0,0,52.65,0,47.35
2021-03-25T00:00:00.000Z,10227,5232844,56.27,35405,4714648,50.7,0,0,0,0,0,0,53.04,0,46.96
2021-03-26T00:00:00.000Z,4159,5237003,56.32,13313,4727961,50.84,0,0,0,0,0,0,53.22,0,46.78
2021-03-27T00:00:00.000Z,1770,5238773,56.34,4256,4732217,50.89,0,0,0,0,0,0,53.31,0,46.69
2021-03-28T00:00:00.000Z,2096,5240869,56.36,4598,4736815,50.94,0,0,0,0,0,0,53.55,0,46.45
2021-03-29T00:00:00.000Z,6884,5247753,56.43,29994,4766809,51.26,0,0,0,0,0,0,53.81,0,46.19
2021-03-30T00:00:00.000Z,7851,5255604,56.52,22414,4789223,51.5,0,0,0,0,0,0,53.9,0,46.1
2021-03-31T00:00:00.000Z,8121,5263725,56.6,19452,4808675,51.71,0,0,0,0,0,0,54.2,0,45.8
2021-04-01T00:00:00.000Z,8161,5271886,56.69,18672,4827347,51.91,0,0,0,0,0,0,54.43,0,45.57
2021-04-02T00:00:00.000Z,2912,5274798,56.72,8109,4835456,52,0,0,0,0,0,0,54.52,0,45.48
2021-04-03T00:00:00.000Z,1411,5276209,56.74,2956,4838412,52.03,0,0,0,0,0,0,54.55,0,45.45
2021-04-04T00:00:00.000Z,9609,5285818,56.84,22815,4861227,52.28,0,0,0,0,0,0,54.64,0,45.36
2021-04-05T00:00:00.000Z,10324,5296142,56.95,21236,4882463,52.5,0,0,0,0,0,0,54.86,0,45.14
2021-04-06T00:00:00.000Z,8993,5305135,57.05,16756,4899219,52.68,0,0,0,0,0,0,55.03,0,44.97
2021-04-07T00:00:00.000Z,8890,5314025,57.14,15267,4914486,52.85,0,0,0,0,0,0,55.18,0,44.82
2021-04-08T00:00:00.000Z,9381,5323406,57.25,16975,4931461,53.03,0,0,0,0,0,0,55.34,0,44.66
2021-04-09T00:00:00.000Z,3573,5326979,57.28,6212,4937673,53.1,0,0,0,0,0,0,55.4,0,44.6
2021-04-10T00:00:00.000Z,1616,5328595,57.3,3502,4941175,53.13,0,0,0,0,0,0,55.43,0,44.57
2021-04-11T00:00:00.000Z,9015,5337610,57.4,14220,4955395,53.29,0,0,0,0,0,0,55.61,0,44.39
2021-04-12T00:00:00.000Z,8904,5346514,57.49,13205,4968600,53.43,0,0,0,0,0,0,55.77,0,44.23
2021-04-13T00:00:00.000Z,5802,5352316,57.56,4926,4973526,53.48,0,0,0,0,0,0,55.9,0,44.1
2021-04-14T00:00:00.000Z,3613,5355929,57.59,5278,4978804,53.54,0,0,0,0,0,0,56,0,44
2021-04-15T00:00:00.000Z,668,5356597,57.6,556,4979360,53.55,0,0,0,0,0,0,56.1,0,43.9
2021-04-16T00:00:00.000Z,3378,5359975,57.64,6623,4985983,53.62,0,0,0,0,0,0,56.15,0,43.85
2021-04-17T00:00:00.000Z,804,5360779,57.65,1959,4987942,53.64,0,0,0,0,0,0,56.17,0,43.83
2021-04-18T00:00:00.000Z,7083,5367862,57.72,7418,4995360,53.72,0,0,0,0,0,0,56.29,0,43.71
2021-04-19T00:00:00.000Z,6373,5374235,57.79,7098,5002458,53.79,0,0,0,0,0,0,56.4,0,43.6
2021-04-20T00:00:00.000Z,6246,5380481,57.86,6850,5009308,53.87,0,0,0,0,0,0,56.47,0,43.53
2021-04-21T00:00:00.000Z,6346,5386827,57.93,7072,5016380,53.94,0,0,0,0,0,0,56.54,0,43.46
2021-04-22T00:00:00.000Z,5917,5392744,57.99,7662,5024042,54.03,0,0,0,0,0,0,56.58,0,43.42
2021-04-23T00:00:00.000Z,2738,5395482,58.02,3362,5027404,54.06,0,0,0,0,0,0,56.63,0,43.37
2021-04-24T00:00:00.000Z,755,5396237,58.03,1276,5028680,54.08,0,0,0,0,0,0,56.64,0,43.36
2021-04-25T00:00:00.000Z,4817,5401054,58.08,6906,5035586,54.15,0,0,0,0,0,0,56.71,0,43.29
2021-04-26T00:00:00.000Z,5457,5406511,58.14,7867,5043453,54.23,0,0,0,0,0,0,56.79,0,43.21
2021-04-27T00:00:00.000Z,4485,5410996,58.19,6600,5050053,54.31,0,0,0,0,0,0,56.85,0,43.15
2021-04-28T00:00:00.000Z,4465,5415461,58.24,7286,5057339,54.38,0,0,0,0,0,0,56.92,0,43.08
2021-04-29T00:00:00.000Z,4342,5419803,58.28,7250,5064589,54.46,0,0,0,0,0,0,56.99,0,43.01
2021-04-30T00:00:00.000Z,1900,5421703,58.3,3162,5067751,54.5,0,0,0,0,0,0,57.02,0,42.98
2021-05-01T00:00:00.000Z,446,5422149,58.31,885,5068636,54.51,0,0,0,0,0,0,57.03,0,42.97
2021-05-02T00:00:00.000Z,3215,5425364,58.34,6067,5074703,54.57,0,0,0,0,0,0,57.08,0,42.92
2021-05-03T00:00:00.000Z,3525,5428889,58.38,5791,5080494,54.63,0,0,0,0,0,0,57.15,0,42.85
2021-05-04T00:00:00.000Z,3560,5432449,58.42,4701,5085195,54.68,0,0,0,0,0,0,57.2,0,42.8
2021-05-05T00:00:00.000Z,3267,5435716,58.45,4056,5089251,54.73,0,0,0,0,0,0,57.26,0,42.74
2021-05-06T00:00:00.000Z,3615,5439331,58.49,3101,5092352,54.76,0,0,0,0,0,0,57.32,0,42.68
2021-05-07T00:00:00.000Z,1806,5441137,58.51,2473,5094825,54.79,0,0,0,0,0,0,57.35,0,42.65
2021-05-08T00:00:00.000Z,230,5441367,58.51,492,5095317,54.79,0,0,0,0,0,0,57.35,0,42.65
2021-05-09T00:00:00.000Z,2836,5444203,58.54,4735,5100052,54.84,0,0,0,0,0,0,57.4,0,42.6
2021-05-10T00:00:00.000Z,2879,5447082,58.58,4679,5104731,54.89,0,0,0,0,0,0,57.45,0,42.55
2021-05-11T00:00:00.000Z,2602,5449684,58.6,3851,5108582,54.94,0,0,0,0,0,0,57.49,0,42.51
2021-05-12T00:00:00.000Z,1996,5451680,58.62,3306,5111888,54.97,0,0,0,0,0,0,57.53,0,42.47
2021-05-13T00:00:00.000Z,2025,5453705,58.65,3647,5115535,55.01,0,0,0,0,0,0,57.56,0,42.44
2021-05-14T00:00:00.000Z,950,5454655,58.66,1469,5117004,55.03,0,0,0,0,0,0,57.57,0,42.43
2021-05-15T00:00:00.000Z,236,5454891,58.66,238,5117242,55.03,0,0,0,0,0,0,57.58,0,42.42
2021-05-16T00:00:00.000Z,522,5455413,58.66,1196,5118438,55.04,0,0,0,0,0,0,57.6,0,42.4
2021-05-17T00:00:00.000Z,286,5455699,58.67,829,5119267,55.05,0,0,0,0,0,0,57.63,0,42.37
2021-05-18T00:00:00.000Z,1943,5457642,58.69,4920,5124187,55.1,0,0,0,0,0,0,57.66,0,42.34
2021-05-19T00:00:00.000Z,2204,5459846,58.71,5017,5129204,55.16,0,0,0,0,0,0,57.69,0,42.31
2021-05-20T00:00:00.000Z,2296,5462142,58.74,3859,5133063,55.2,0,0,0,0,0,0,57.72,0,42.28
2021-05-21T00:00:00.000Z,1163,5463305,58.75,1380,5134443,55.21,0,0,0,0,0,0,57.74,0,42.26
2021-05-22T00:00:00.000Z,203,5463508,58.75,383,5134826,55.22,0,0,0,0,0,0,57.74,0,42.26
2021-05-23T00:00:00.000Z,2266,5465774,58.78,3208,5138034,55.25,0,0,0,0,0,0,57.76,0,42.24
2021-05-24T00:00:00.000Z,2111,5467885,58.8,3578,5141612,55.29,0,0,0,0,0,0,57.78,0,42.22
2021-05-25T00:00:00.000Z,1805,5469690,58.82,2567,5144179,55.32,0,0,0,0,0,0,57.81,0,42.19
2021-05-26T00:00:00.000Z,1389,5471079,58.83,2475,5146654,55.34,0,0,0,0,0,0,57.85,0,42.15
2021-05-27T00:00:00.000Z,1824,5472903,58.85,3160,5149814,55.38,0,0,0,0,0,0,57.88,0,42.12
2021-05-28T00:00:00.000Z,756,5473659,58.86,1383,5151197,55.39,0,0,0,0,0,0,57.89,0,42.11
2021-05-29T00:00:00.000Z,170,5473829,58.86,215,5151412,55.4,0,0,0,0,0,0,57.89,0,42.11
2021-05-30T00:00:00.000Z,1630,5475459,58.88,1921,5153333,55.42,0,0,0,0,0,0,57.92,0,42.08
2021-05-31T00:00:00.000Z,1711,5477170,58.9,2077,5155410,55.44,0,0,0,0,0,0,57.95,0,42.05
2021-06-01T00:00:00.000Z,1351,5478521,58.91,1804,5157214,55.46,0,0,0,0,0,0,57.97,0,42.03
2021-06-02T00:00:00.000Z,1483,5480004,58.93,1589,5158803,55.48,0,0,0,0,0,0,57.99,0,42.01
2021-06-03T00:00:00.000Z,1657,5481661,58.95,1468,5160271,55.49,0,0,0,0,0,0,58.01,0,41.99
2021-06-04T00:00:00.000Z,1068,5482729,58.96,761,5161032,55.5,0,0,0,0,0,0,58.03,0,41.97
2021-06-05T00:00:00.000Z,172,5482901,58.96,148,5161180,55.5,0,0,0,0,0,0,58.03,0,41.97
2021-06-06T00:00:00.000Z,4275,5487176,59.01,986,5162166,55.51,0,0,0,0,0,0,58.07,0,41.93
2021-06-07T00:00:00.000Z,4408,5491584,59.05,789,5162955,55.52,0,0,0,0,0,0,58.1,0,41.9
2021-06-08T00:00:00.000Z,3716,5495300,59.09,1149,5164104,55.53,0,0,0,0,0,0,58.14,0,41.86
2021-06-09T00:00:00.000Z,3571,5498871,59.13,1298,5165402,55.55,0,0,0,0,0,0,58.17,0,41.83
2021-06-10T00:00:00.000Z,3323,5502194,59.17,1273,5166675,55.56,0,0,0,0,0,0,58.2,0,41.8
2021-06-11T00:00:00.000Z,1371,5503565,59.18,564,5167239,55.57,0,0,0,0,0,0,58.21,0,41.79
2021-06-12T00:00:00.000Z,203,5503768,59.18,158,5167397,55.57,0,0,0,0,0,0,58.21,0,41.79
2021-06-13T00:00:00.000Z,3094,5506862,59.22,1244,5168641,55.58,0,0,0,0,0,0,58.24,0,41.76
2021-06-14T00:00:00.000Z,3029,5509891,59.25,1511,5170152,55.6,0,0,0,0,0,0,58.26,0,41.74
2021-06-15T00:00:00.000Z,3119,5513010,59.28,1351,5171503,55.61,0,0,0,0,0,0,58.28,0,41.72
2021-06-16T00:00:00.000Z,2702,5515712,59.31,976,5172479,55.62,0,0,0,0,0,0,58.31,0,41.69
2021-06-17T00:00:00.000Z,2704,5518416,59.34,1176,5173655,55.63,0,0,0,0,0,0,58.33,0,41.67
2021-06-18T00:00:00.000Z,1241,5519657,59.36,477,5174132,55.64,0,0,0,0,0,0,58.34,0,41.66
2021-06-19T00:00:00.000Z,216,5519873,59.36,132,5174264,55.64,0,0,0,0,0,0,58.34,0,41.66
2021-06-20T00:00:00.000Z,3302,5523175,59.39,1314,5175578,55.66,0,0,0,0,0,0,58.37,0,41.63
2021-06-21T00:00:00.000Z,5227,5528402,59.45,1191,5176769,55.67,0,0,0,0,0,0,58.41,0,41.59
2021-06-22T00:00:00.000Z,6901,5535303,59.52,1080,5177849,55.68,0,0,0,0,0,0,58.46,0,41.54
2021-06-23T00:00:00.000Z,10712,5546015,59.64,1272,5179121,55.69,0,0,0,0,0,0,58.54,0,41.46
2021-06-24T00:00:00.000Z,12006,5558021,59.77,1442,5180563,55.71,0,0,0,0,0,0,58.62,0,41.38
2021-06-25T00:00:00.000Z,7080,5565101,59.84,910,5181473,55.72,0,0,0,0,0,0,58.67,0,41.33
2021-06-26T00:00:00.000Z,2256,5567357,59.87,187,5181660,55.72,0,0,0,0,0,0,58.68,0,41.32
2021-06-27T00:00:00.000Z,13607,5580964,60.01,3426,5185086,55.76,0,0,0,0,0,0,58.78,0,41.22
2021-06-28T00:00:00.000Z,14491,5595455,60.17,3652,5188738,55.8,0,0,0,0,0,0,58.88,0,41.12
2021-06-29T00:00:00.000Z,16682,5612137,60.35,3713,5192451,55.84,0,0,0,0,0,0,58.99,0,41.01
2021-06-30T00:00:00.000Z,16455,5628592,60.53,3370,5195821,55.87,0,0,0,0,0,0,59.11,0,40.89
2021-07-01T00:00:00.000Z,16784,5645376,60.71,3346,5199167,55.91,69,69,0,0,0,0,59.23,0,40.77
2021-07-02T00:00:00.000Z,9807,5655183,60.81,1571,5200738,55.93,4,73,0,0,0,0,59.3,0,40.7
2021-07-03T00:00:00.000Z,2656,5657839,60.84,286,5201024,55.93,1,74,0,0,0,0,59.32,0,40.68
2021-07-04T00:00:00.000Z,17715,5675554,61.03,3146,5204170,55.96,0,74,0,0,0,0,59.46,0,40.54
2021-07-05T00:00:00.000Z,17827,5693381,61.22,3018,5207188,56,4,78,0,0,0,0,59.6,0,40.4
2021-07-06T00:00:00.000Z,17815,5711196,61.42,3390,5210578,56.03,10,88,0,0,0,0,59.74,0,40.26
2021-07-07T00:00:00.000Z,15502,5726698,61.58,2667,5213245,56.06,11,99,0,0,0,0,59.87,0,40.13
2021-07-08T00:00:00.000Z,16555,5743253,61.76,2832,5216077,56.09,15,114,0,0,0,0,60,0,40
2021-07-09T00:00:00.000Z,11107,5754360,61.88,1503,5217580,56.11,3,117,0,0,0,0,60.09,0,39.91
2021-07-10T00:00:00.000Z,4961,5759321,61.93,372,5217952,56.11,5,122,0,0,0,0,60.13,0,39.87
2021-07-11T00:00:00.000Z,1445,5760766,61.95,2837,5220789,56.14,5,127,0,0,0,0,60.16,0,39.84
2021-07-12T00:00:00.000Z,2398,5763164,61.97,3667,5224456,56.18,50,177,0,0,0,0,60.2,0,39.8
2021-07-13T00:00:00.000Z,2939,5766103,62.01,5431,5229887,56.24,124,301,0,0,0,0,60.25,0,39.75
2021-07-14T00:00:00.000Z,2714,5768817,62.03,7489,5237376,56.32,440,741,0.01,0,0,0,60.29,0,39.71
2021-07-15T00:00:00.000Z,2965,5771782,62.07,9262,5246638,56.42,373,1114,0.01,0,0,0,60.34,0,39.66
2021-07-16T00:00:00.000Z,1258,5773040,62.08,5863,5252501,56.48,65,1179,0.01,0,0,0,60.36,0,39.64
2021-07-17T00:00:00.000Z,348,5773388,62.08,1376,5253877,56.5,6,1185,0.01,0,0,0,60.37,0,39.63
2021-07-18T00:00:00.000Z,2047,5775435,62.11,9757,5263634,56.6,235,1420,0.02,0,0,0,60.4,0,39.6
2021-07-19T00:00:00.000Z,3181,5778616,62.14,11318,5274952,56.72,457,1877,0.02,0,0,0,60.44,0,39.56
2021-07-20T00:00:00.000Z,2652,5781268,62.17,11883,5286835,56.85,370,2247,0.02,0,0,0,60.42,0.07,39.51
2021-07-21T00:00:00.000Z,2356,5783624,62.19,11850,5298685,56.98,322,2569,0.03,0,0,0,60.26,0.28,39.46
2021-07-22T00:00:00.000Z,2854,5786478,62.22,13228,5311913,57.12,389,2958,0.03,0,0,0,59.93,0.67,39.4
2021-07-23T00:00:00.000Z,2011,5788489,62.25,8198,5320111,57.21,102,3060,0.03,0,0,0,59.35,1.29,39.36
2021-07-24T00:00:00.000Z,615,5789104,62.25,1462,5321573,57.23,6,3066,0.03,0,0,0,58.61,2.04,39.35
2021-07-25T00:00:00.000Z,4406,5793510,62.3,15472,5337045,57.39,223,3289,0.04,0,0,0,58.29,2.43,39.28
2021-07-26T00:00:00.000Z,5146,5798656,62.36,13498,5350543,57.54,322,3611,0.04,0,0,0,58.1,2.71,39.19
2021-07-27T00:00:00.000Z,5461,5804117,62.41,13530,5364073,57.68,412,4023,0.04,0,0,0,57.27,3.63,39.1
2021-07-28T00:00:00.000Z,3964,5808081,62.46,12310,5376383,57.82,469,4492,0.05,0,0,0,56.05,4.93,39.02
2021-07-29T00:00:00.000Z,4634,5812715,62.51,14148,5390531,57.97,526,5018,0.05,0,0,0,54.65,6.41,38.93
2021-07-30T00:00:00.000Z,2631,5815346,62.54,10824,5401355,58.08,4115,9133,0.1,0,0,0,53.18,7.92,38.9
2021-07-31T00:00:00.000Z,1389,5816735,62.55,3533,5404888,58.12,6154,15287,0.16,0,0,0,51.46,9.64,38.9
2021-08-01T00:00:00.000Z,3060,5819795,62.58,3345,5408233,58.16,31041,46328,0.5,0,0,0,50.94,10.15,38.92
2021-08-02T00:00:00.000Z,3108,5822903,62.62,3148,5411381,58.19,58500,104828,1.13,0,0,0,50.72,10.24,39.03
2021-08-03T00:00:00.000Z,3362,5826265,62.65,3293,5414674,58.23,78951,183779,1.98,0,0,0,49.7,11.07,39.23
2021-08-04T00:00:00.000Z,3511,5829776,62.69,3224,5417898,58.26,80746,264525,2.84,0,0,0,48.7,11.86,39.44
2021-08-05T00:00:00.000Z,4488,5834264,62.74,3545,5421443,58.3,88432,352957,3.8,0,0,0,47.92,12.4,39.68
2021-08-06T00:00:00.000Z,2398,5836662,62.76,1822,5423265,58.32,44738,397695,4.28,0,0,0,46.97,13.26,39.77
2021-08-07T00:00:00.000Z,1015,5837677,62.78,660,5423925,58.33,27348,425043,4.57,0,0,0,45.82,14.34,39.84
2021-08-08T00:00:00.000Z,4992,5842669,62.83,3052,5426977,58.36,80067,505110,5.43,0,0,0,45.73,14.27,40
2021-08-09T00:00:00.000Z,5326,5847995,62.89,3027,5430004,58.39,76476,581586,6.25,0,0,0,45.97,13.98,40.05
2021-08-10T00:00:00.000Z,5537,5853532,62.95,3163,5433167,58.43,75411,656997,7.07,0,0,0,46.18,13.81,40.01
2021-08-11T00:00:00.000Z,5676,5859208,63.01,2919,5436086,58.46,62619,719616,7.74,0,0,0,46.57,13.52,39.91
2021-08-12T00:00:00.000Z,7013,5866221,63.08,3267,5439353,58.49,59449,779065,8.38,0,0,0,47.05,13.21,39.74
2021-08-13T00:00:00.000Z,3795,5870016,63.12,2044,5441397,58.51,43854,822919,8.85,0,0,0,47.01,13.29,39.7
2021-08-14T00:00:00.000Z,2246,5872262,63.15,836,5442233,58.52,44467,867386,9.33,0,0,0,46.77,13.49,39.74
2021-08-15T00:00:00.000Z,7157,5879419,63.22,4517,5446750,58.57,97944,965330,10.38,0,0,0,47.43,12.85,39.72
2021-08-16T00:00:00.000Z,6973,5886392,63.3,4723,5451473,58.62,89490,1054820,11.34,0,0,0,48.08,12.25,39.68
2021-08-17T00:00:00.000Z,7573,5893965,63.38,5115,5456588,58.68,83281,1138101,12.24,0,0,0,48.24,12.15,39.61
2021-08-18T00:00:00.000Z,8629,5902594,63.47,4589,5461177,58.73,69232,1207333,12.98,0,0,0,48.3,12.17,39.53
2021-08-19T00:00:00.000Z,10063,5912657,63.58,5193,5466370,58.78,65950,1273283,13.69,0,0,0,48.32,12.24,39.44
2021-08-20T00:00:00.000Z,4731,5917388,63.63,2789,5469159,58.81,60424,1333707,14.34,0,0,0,48.14,12.41,39.44
2021-08-21T00:00:00.000Z,3487,5920875,63.67,1551,5470710,58.83,50707,1384414,14.89,0,0,0,47.9,12.68,39.42
2021-08-22T00:00:00.000Z,9833,5930708,63.78,4783,5475493,58.88,105067,1489481,16.02,0,0,0,48.58,12.09,39.32
2021-08-23T00:00:00.000Z,10926,5941634,63.89,4422,5479915,58.93,93970,1583451,17.03,0,0,0,49.21,11.58,39.21
2021-08-24T00:00:00.000Z,11728,5953362,64.02,4688,5484603,58.98,98479,1681930,18.09,0,0,0,49.46,11.42,39.12
2021-08-25T00:00:00.000Z,9627,5962989,64.12,4456,5489059,59.03,99451,1781381,19.16,0,0,0,49.56,11.37,39.07
2021-08-26T00:00:00.000Z,10106,5973095,64.23,5029,5494088,59.08,101147,1882528,20.24,0,0,0,49.63,11.33,39.04
2021-08-27T00:00:00.000Z,4316,5977411,64.28,2758,5496846,59.11,56659,1939187,20.85,0,0,0,49.51,11.55,38.95
2021-08-28T00:00:00.000Z,3692,5981103,64.32,1475,5498321,59.13,33512,1972699,21.21,0,0,0,49.19,11.98,38.84
2021-08-29T00:00:00.000Z,10342,5991445,64.43,5925,5504246,59.19,79469,2052168,22.07,0,0,0,49.75,11.65,38.61
2021-08-30T00:00:00.000Z,12347,6003792,64.56,6996,5511242,59.27,115935,2168103,23.31,0,0,0,50.44,11.05,38.51
2021-08-31T00:00:00.000Z,12089,6015881,64.69,6496,5517738,59.34,114797,2282900,24.55,0,0,0,50.77,10.82,38.41
2021-09-01T00:00:00.000Z,9058,6024939,64.79,5994,5523732,59.4,112416,2395316,25.76,0,0,0,51.06,10.58,38.36
2021-09-02T00:00:00.000Z,8801,6033740,64.88,7152,5530884,59.48,111453,2506769,26.96,0,0,0,51.47,10.22,38.31
2021-09-03T00:00:00.000Z,3739,6037479,64.92,4087,5534971,59.52,58851,2565620,27.59,0,0,0,51.53,10.2,38.27
2021-09-04T00:00:00.000Z,2691,6040170,64.95,2006,5536977,59.54,29930,2595550,27.91,0,0,0,51.36,10.4,38.23
2021-09-05T00:00:00.000Z,7011,6047181,65.03,6448,5543425,59.61,73277,2668827,28.7,1,1,0,51.84,10.03,38.14
2021-09-06T00:00:00.000Z,2822,6050003,65.06,2674,5546099,59.64,22776,2691603,28.94,0,1,0,52.27,9.9,37.83
2021-09-07T00:00:00.000Z,1186,6051189,65.07,854,5546953,59.65,5381,2696984,29,0,1,0,52.37,10.13,37.5
2021-09-08T00:00:00.000Z,1374,6052563,65.09,1167,5548120,59.66,6608,2703592,29.07,0,1,0,52.44,10.39,37.17
2021-09-09T00:00:00.000Z,7103,6059666,65.16,12539,5560659,59.8,73793,2777385,29.87,0,1,0,52.79,10.21,36.99
2021-09-10T00:00:00.000Z,3245,6062911,65.2,4983,5565642,59.85,37908,2815293,30.27,0,1,0,52.75,10.34,36.91
2021-09-11T00:00:00.000Z,2108,6065019,65.22,2487,5568129,59.88,14801,2830094,30.43,0,1,0,52.38,10.77,36.85
2021-09-12T00:00:00.000Z,6117,6071136,65.29,8580,5576709,59.97,54091,2884185,31.02,0,1,0,52.69,10.57,36.74
2021-09-13T00:00:00.000Z,5623,6076759,65.35,8233,5584942,60.06,47922,2932107,31.53,0,1,0,52.86,10.37,36.76
2021-09-14T00:00:00.000Z,4955,6081714,65.4,7398,5592340,60.14,48818,2980925,32.06,0,1,0,52.63,10.52,36.85
2021-09-15T00:00:00.000Z,1737,6083451,65.42,2691,5595031,60.17,16669,2997594,32.23,0,1,0,52.21,10.93,36.86
2021-09-16T00:00:00.000Z,333,6083784,65.42,534,5595565,60.17,1735,2999329,32.25,0,1,0,51.98,11.42,36.59
2021-09-17T00:00:00.000Z,3674,6087458,65.46,6997,5602562,60.25,42866,3042195,32.71,0,1,0,51.93,11.5,36.57
2021-09-18T00:00:00.000Z,2249,6089707,65.49,2930,5605492,60.28,12777,3054972,32.85,0,1,0,51.53,11.93,36.54
2021-09-19T00:00:00.000Z,5968,6095675,65.55,10701,5616193,60.39,44284,3099256,33.33,0,1,0,51.73,11.82,36.44
2021-09-20T00:00:00.000Z,3240,6098915,65.58,4620,5620813,60.44,16681,3115937,33.51,0,1,0,51.86,11.84,36.3
2021-09-21T00:00:00.000Z,1327,6100242,65.6,2036,5622849,60.47,3465,3119402,33.54,0,1,0,51.53,12.34,36.13
2021-09-22T00:00:00.000Z,4255,6104497,65.64,7227,5630076,60.54,25037,3144439,33.81,0,1,0,51.13,12.74,36.12
2021-09-23T00:00:00.000Z,4396,6108893,65.69,5886,5635962,60.61,27794,3172233,34.11,0,1,0,50.75,13.08,36.17
2021-09-24T00:00:00.000Z,3196,6112089,65.73,4167,5640129,60.65,27696,3199929,34.41,0,1,0,50.65,13.27,36.08
2021-09-25T00:00:00.000Z,2080,6114169,65.75,2243,5642372,60.68,10422,3210351,34.52,0,1,0,50.32,13.63,36.05
2021-09-26T00:00:00.000Z,5622,6119791,65.81,5963,5648335,60.74,36229,3246580,34.91,0,1,0,50.56,13.48,35.95
2021-09-27T00:00:00.000Z,4695,6124486,65.86,4445,5652780,60.79,30423,3277003,35.24,1,2,0,50.72,13.33,35.95
2021-09-28T00:00:00.000Z,1459,6125945,65.88,1162,5653942,60.8,6228,3283231,35.31,0,2,0,50.48,13.59,35.94
2021-09-29T00:00:00.000Z,9642,6135587,65.98,8327,5662269,60.89,60269,3343500,35.95,0,2,0,50.67,13.36,35.97
2021-09-30T00:00:00.000Z,10975,6146562,66.1,8547,5670816,60.98,79650,3423150,36.81,0,2,0,51.24,12.7,36.07
2021-10-01T00:00:00.000Z,5118,6151680,66.15,3847,5674663,61.02,46489,3469639,37.31,0,2,0,51.32,12.6,36.08
2021-10-02T00:00:00.000Z,2863,6154543,66.18,2114,5676777,61.05,22411,3492050,37.55,0,2,0,51.24,12.67,36.09
2021-10-03T00:00:00.000Z,11676,6166219,66.31,7255,5684032,61.12,70682,3562732,38.31,0,2,0,51.81,12.09,36.11
2021-10-04T00:00:00.000Z,10323,6176542,66.42,6736,5690768,61.2,51852,3614584,38.87,0,2,0,52.28,11.63,36.09
2021-10-05T00:00:00.000Z,8451,6184993,66.51,5285,5696053,61.25,40437,3655021,39.3,0,2,0,52.55,11.31,36.15
2021-10-06T00:00:00.000Z,7573,6192566,66.59,4159,5700212,61.3,34065,3689086,39.67,0,2,0,52.9,11.14,35.96
2021-10-07T00:00:00.000Z,6912,6199478,66.67,3984,5704196,61.34,33999,3723085,40.04,0,2,0,53.39,10.91,35.7
2021-10-08T00:00:00.000Z,3086,6202564,66.7,2619,5706815,61.37,19205,3742290,40.24,0,2,0,53.62,10.82,35.56
2021-10-09T00:00:00.000Z,1333,6203897,66.71,1427,5708242,61.38,7422,3749712,40.32,0,2,0,53.66,10.85,35.49
2021-10-10T00:00:00.000Z,4684,6208581,66.76,3733,5711975,61.42,21488,3771200,40.55,0,2,0,54.13,10.63,35.24
2021-10-11T00:00:00.000Z,4296,6212877,66.81,2926,5714901,61.46,17235,3788435,40.74,0,2,0,54.51,10.44,35.05
2021-10-12T00:00:00.000Z,3971,6216848,66.85,2981,5717882,61.49,15333,3803768,40.9,0,2,0,54.66,10.42,34.91
2021-10-13T00:00:00.000Z,3494,6220342,66.89,2434,5720316,61.51,13531,3817299,41.05,0,2,0,54.81,10.41,34.78
2021-10-14T00:00:00.000Z,3871,6224213,66.93,2668,5722984,61.54,16520,3833819,41.23,0,2,0,55,10.34,34.66
2021-10-15T00:00:00.000Z,1695,6225908,66.95,1657,5724641,61.56,8979,3842798,41.32,0,2,0,55.07,10.34,34.59
2021-10-16T00:00:00.000Z,731,6226639,66.96,935,5725576,61.57,4017,3846815,41.37,0,2,0,55.02,10.42,34.56
2021-10-17T00:00:00.000Z,3106,6229745,66.99,2512,5728088,61.6,12762,3859577,41.5,0,2,0,55.21,10.31,34.48
2021-10-18T00:00:00.000Z,2455,6232200,67.02,1657,5729745,61.61,10030,3869607,41.61,0,2,0,55.36,10.23,34.41
2021-10-19T00:00:00.000Z,2384,6234584,67.04,1262,5731007,61.63,9272,3878879,41.71,0,2,0,55.42,10.23,34.35
2021-10-20T00:00:00.000Z,2438,6237022,67.07,2279,5733286,61.65,10052,3888931,41.82,0,2,0,55.49,10.21,34.3
2021-10-21T00:00:00.000Z,3030,6240052,67.1,3071,5736357,61.69,12109,3901040,41.95,0,2,0,55.64,10.12,34.24
2021-10-22T00:00:00.000Z,1273,6241325,67.12,1409,5737766,61.7,5798,3906838,42.01,0,2,0,55.7,10.09,34.21
2021-10-23T00:00:00.000Z,558,6241883,67.12,1252,5739018,61.71,2551,3909389,42.04,0,2,0,55.74,10.07,34.2
2021-10-24T00:00:00.000Z,2510,6244393,67.15,2652,5741670,61.74,9831,3919220,42.15,0,2,0,55.84,10.01,34.15
2021-10-25T00:00:00.000Z,2629,6247022,67.18,2718,5744388,61.77,8469,3927689,42.24,0,2,0,55.95,9.94,34.11
2021-10-26T00:00:00.000Z,2371,6249393,67.2,2030,5746418,61.79,8492,3936181,42.33,0,2,0,56.02,9.9,34.08
2021-10-27T00:00:00.000Z,2299,6251692,67.23,2545,5748963,61.82,7916,3944097,42.41,0,2,0,56.09,9.87,34.04
2021-10-28T00:00:00.000Z,2494,6254186,67.25,2747,5751710,61.85,8633,3952730,42.51,0,2,0,56.17,9.83,33.99
2021-10-29T00:00:00.000Z,885,6255071,67.26,1122,5752832,61.86,4101,3956831,42.55,0,2,0,56.19,9.84,33.98
2021-10-30T00:00:00.000Z,353,6255424,67.27,516,5753348,61.87,1698,3958529,42.57,0,2,0,56.16,9.87,33.96
2021-10-31T00:00:00.000Z,2266,6257690,67.29,2479,5755827,61.9,8226,3966755,42.66,0,2,0,56.26,9.81,33.93
2021-11-01T00:00:00.000Z,1730,6259420,67.31,2079,5757906,61.92,6438,3973193,42.73,0,2,0,56.35,9.76,33.89
2021-11-02T00:00:00.000Z,2025,6261445,67.33,2019,5759925,61.94,6247,3979440,42.79,1,3,0,56.4,9.74,33.86
2021-11-03T00:00:00.000Z,1762,6263207,67.35,1873,5761798,61.96,5511,3984951,42.85,0,3,0,56.43,9.74,33.83
2021-11-04T00:00:00.000Z,2108,6265315,67.37,2782,5764580,61.99,7082,3992033,42.93,0,3,0,56.49,9.72,33.79
2021-11-05T00:00:00.000Z,771,6266086,67.38,881,5765461,62,3431,3995464,42.97,0,3,0,56.48,9.73,33.78
2021-11-06T00:00:00.000Z,340,6266426,67.39,379,5765840,62,1359,3996823,42.98,0,3,0,56.45,9.77,33.77
2021-11-07T00:00:00.000Z,1585,6268011,67.4,1764,5767604,62.02,6112,4002935,43.05,0,3,0,56.53,9.73,33.74
2021-11-08T00:00:00.000Z,1513,6269524,67.42,1575,5769179,62.04,5373,4008308,43.1,0,3,0,56.6,9.68,33.72
2021-11-09T00:00:00.000Z,1425,6270949,67.43,1581,5770760,62.06,5297,4013605,43.16,0,3,0,56.63,9.67,33.7
2021-11-10T00:00:00.000Z,1428,6272377,67.45,1638,5772398,62.07,4730,4018335,43.21,0,3,0,56.66,9.67,33.68
2021-11-11T00:00:00.000Z,1628,6274005,67.47,1920,5774318,62.09,5655,4023990,43.27,3,6,0,56.71,9.64,33.65
2021-11-12T00:00:00.000Z,620,6274625,67.47,805,5775123,62.1,2884,4026874,43.3,0,6,0,56.72,9.64,33.64
2021-11-13T00:00:00.000Z,248,6274873,67.48,279,5775402,62.11,1104,4027978,43.31,0,6,0,56.71,9.66,33.63
2021-11-14T00:00:00.000Z,1544,6276417,67.49,1622,5777024,62.12,5085,4033063,43.37,1,7,0,56.77,9.62,33.61
2021-11-15T00:00:00.000Z,1263,6277680,67.51,1604,5778628,62.14,4740,4037803,43.42,0,7,0,56.83,9.58,33.59
2021-11-16T00:00:00.000Z,1278,6278958,67.52,1390,5780018,62.16,4296,4042099,43.47,0,7,0,56.86,9.57,33.57
2021-11-17T00:00:00.000Z,1212,6280170,67.53,1541,5781559,62.17,3848,4045947,43.51,0,7,0,56.89,9.57,33.55
2021-11-18T00:00:00.000Z,1354,6281524,67.55,1667,5783226,62.19,4968,4050915,43.56,0,7,0,56.93,9.54,33.53
2021-11-19T00:00:00.000Z,585,6282109,67.55,741,5783967,62.2,2413,4053328,43.59,0,7,0,56.94,9.54,33.52
2021-11-20T00:00:00.000Z,234,6282343,67.56,234,5784201,62.2,904,4054232,43.6,1,8,0,56.93,9.56,33.51
2021-11-21T00:00:00.000Z,1426,6283769,67.57,1517,5785718,62.22,4847,4059079,43.65,0,8,0,56.98,9.52,33.5
2021-11-22T00:00:00.000Z,1675,6285444,67.59,1504,5787222,62.23,4190,4063269,43.69,1,9,0,57.04,9.48,33.47
2021-11-23T00:00:00.000Z,8617,6294061,67.68,1662,5788884,62.25,3954,4067223,43.74,0,9,0,57.14,9.46,33.4
2021-11-24T00:00:00.000Z,9354,6303415,67.78,1295,5790179,62.26,3870,4071093,43.78,0,9,0,57.23,9.44,33.33
2021-11-25T00:00:00.000Z,9821,6313236,67.89,1577,5791756,62.28,4794,4075887,43.83,0,9,0,57.31,9.44,33.25
2021-11-26T00:00:00.000Z,5608,6318844,67.95,727,5792483,62.29,2735,4078622,43.86,0,9,0,57.34,9.46,33.21
2021-11-27T00:00:00.000Z,4777,6323621,68,312,5792795,62.29,1134,4079756,43.87,0,9,0,57.35,9.48,33.17
2021-11-28T00:00:00.000Z,10154,6333775,68.11,1474,5794269,62.31,4867,4084623,43.92,0,9,0,57.46,9.45,33.09
2021-11-29T00:00:00.000Z,9038,6342813,68.21,1123,5795392,62.32,4322,4088945,43.97,0,9,0,57.57,9.42,33.01
2021-11-30T00:00:00.000Z,10046,6352859,68.32,1004,5796396,62.33,4033,4092978,44.01,1,10,0,57.65,9.42,32.93
2021-12-01T00:00:00.000Z,8625,6361484,68.41,1080,5797476,62.34,4379,4097357,44.06,2,12,0,57.73,9.42,32.86
2021-12-02T00:00:00.000Z,9171,6370655,68.51,1429,5798905,62.36,5048,4102405,44.12,4,16,0,57.82,9.4,32.78
2021-12-03T00:00:00.000Z,6339,6376994,68.58,652,5799557,62.37,2810,4105215,44.15,1,17,0,57.87,9.4,32.73
2021-12-04T00:00:00.000Z,2505,6379499,68.6,228,5799785,62.37,890,4106105,44.16,1,18,0,57.88,9.41,32.71
2021-12-05T00:00:00.000Z,8336,6387835,68.69,1248,5801033,62.38,4653,4110758,44.21,0,18,0,57.98,9.39,32.63
2021-12-06T00:00:00.000Z,6726,6394561,68.76,1184,5802217,62.39,4297,4115055,44.25,2,20,0,58.07,9.36,32.57
2021-12-07T00:00:00.000Z,5553,6400114,68.82,1489,5803706,62.41,3913,4118968,44.29,3,23,0,58.13,9.35,32.52
2021-12-08T00:00:00.000Z,4931,6405045,68.88,1186,5804892,62.42,3819,4122787,44.33,3,26,0,58.19,9.33,32.48
2021-12-09T00:00:00.000Z,6243,6411288,68.94,1220,5806112,62.44,4456,4127243,44.38,5,31,0,58.27,9.31,32.42
2021-12-10T00:00:00.000Z,3008,6414296,68.98,672,5806784,62.44,2623,4129866,44.41,1,32,0,58.31,9.3,32.39
2021-12-11T00:00:00.000Z,1490,6415786,68.99,248,5807032,62.45,981,4130847,44.42,0,32,0,58.32,9.3,32.38
2021-12-12T00:00:00.000Z,7278,6423064,69.07,1430,5808462,62.46,5213,4136060,44.48,1,33,0,58.42,9.27,32.32
2021-12-13T00:00:00.000Z,6181,6429245,69.14,1356,5809818,62.48,4299,4140359,44.52,1,34,0,58.5,9.24,32.26
2021-12-14T00:00:00.000Z,7326,6436571,69.22,6084,5815902,62.54,4878,4145237,44.58,7,41,0,58.59,9.21,32.2
2021-12-15T00:00:00.000Z,7206,6443777,69.29,7396,5823298,62.62,5391,4150628,44.63,1,42,0,58.68,9.18,32.14
2021-12-16T00:00:00.000Z,8080,6451857,69.38,8602,5831900,62.71,6495,4157123,44.7,5,47,0,58.78,9.15,32.07
2021-12-17T00:00:00.000Z,4390,6456247,69.43,5118,5837018,62.77,3886,4161009,44.75,3,50,0,58.83,9.14,32.04
2021-12-18T00:00:00.000Z,3936,6460183,69.47,2900,5839918,62.8,1320,4162329,44.76,1,51,0,58.86,9.14,32.01
2021-12-19T00:00:00.000Z,6986,6467169,69.54,9326,5849244,62.9,6231,4168560,44.83,2,53,0,58.96,9.1,31.94
2021-12-20T00:00:00.000Z,7982,6475151,69.63,7506,5856750,62.98,5361,4173921,44.88,4,57,0,59.05,9.08,31.87
2021-12-21T00:00:00.000Z,9556,6484707,69.73,8633,5865383,63.07,6409,4180330,44.95,2,59,0,59.18,9.05,31.77
2021-12-22T00:00:00.000Z,9669,6494376,69.84,8132,5873515,63.16,6185,4186515,45.02,7,66,0,59.31,9.03,31.66
2021-12-23T00:00:00.000Z,11548,6505924,69.96,10257,5883772,63.27,8079,4194594,45.11,9,75,0,59.46,9,31.54
2021-12-24T00:00:00.000Z,5887,6511811,70.02,6234,5890006,63.34,5212,4199806,45.16,4,79,0,59.55,8.98,31.47
2021-12-25T00:00:00.000Z,3337,6515148,70.06,2564,5892570,63.37,2015,4201821,45.18,3,82,0,59.59,8.98,31.44
2021-12-26T00:00:00.000Z,10659,6525807,70.18,8911,5901481,63.46,8178,4209999,45.27,5,87,0,59.75,8.93,31.32
2021-12-27T00:00:00.000Z,10373,6536180,70.29,7136,5908617,63.54,8135,4218134,45.36,79,166,0,59.9,8.89,31.21
2021-12-28T00:00:00.000Z,11380,6547560,70.41,7435,5916052,63.62,9581,4227715,45.46,89,255,0,60.05,8.86,31.09
2021-12-29T00:00:00.000Z,9957,6557517,70.52,5957,5922009,63.68,8302,4236017,45.55,9,264,0,60.19,8.83,30.98
2021-12-30T00:00:00.000Z,11021,6568538,70.63,7725,5929734,63.77,12195,4248212,45.68,4,268,0,60.36,8.79,30.86
2021-12-31T00:00:00.000Z,4838,6573376,70.69,3668,5933402,63.8,7256,4255468,45.76,81,349,0,60.44,8.77,30.8
2022-01-01T00:00:00.000Z,1991,6575367,70.71,1588,5934990,63.82,2737,4258205,45.79,34,383,0,60.46,8.76,30.77
2022-01-02T00:00:00.000Z,10226,6585593,70.82,6488,5941478,63.89,12972,4271177,45.93,331,714,0.01,60.63,8.71,30.66
2022-01-03T00:00:00.000Z,9391,6594984,70.92,5243,5946721,63.95,11280,4282457,46.05,12007,12721,0.14,60.78,8.66,30.56
2022-01-04T00:00:00.000Z,8971,6603955,71.02,5940,5952661,64.01,10470,4292927,46.16,50328,63049,0.68,60.91,8.64,30.46
2022-01-05T00:00:00.000Z,8557,6612512,71.11,5725,5958386,64.07,10424,4303351,46.28,59582,122631,1.32,61.03,8.61,30.37
2022-01-06T00:00:00.000Z,10347,6622859,71.22,7957,5966343,64.16,13485,4316836,46.42,63981,186612,2.01,61.18,8.56,30.26
2022-01-07T00:00:00.000Z,4756,6627615,71.27,4543,5970886,64.21,8098,4324934,46.51,31132,217744,2.34,61.25,8.54,30.21
2022-01-08T00:00:00.000Z,2751,6630366,71.3,2444,5973330,64.23,5466,4330400,46.57,27622,245366,2.64,61.28,8.53,30.19
2022-01-09T00:00:00.000Z,9315,6639681,71.4,7728,5981058,64.32,11842,4342242,46.69,66816,312182,3.36,61.43,8.48,30.09
2022-01-10T00:00:00.000Z,8369,6648050,71.49,7647,5988705,64.4,11821,4354063,46.82,64839,377021,4.05,61.57,8.43,30
2022-01-11T00:00:00.000Z,8108,6656158,71.58,8616,5997321,64.49,11925,4365988,46.95,56680,433701,4.66,61.69,8.4,29.91
2022-01-12T00:00:00.000Z,7276,6663434,71.66,8312,6005633,64.58,11065,4377053,47.07,44595,478296,5.14,61.81,8.35,29.83
2022-01-13T00:00:00.000Z,7517,6670951,71.74,9613,6015246,64.69,11492,4388545,47.19,34758,513054,5.52,62,8.27,29.73
2022-01-14T00:00:00.000Z,2556,6673507,71.76,4923,6020169,64.74,6100,4394645,47.26,11161,524215,5.64,62.08,8.23,29.69
2022-01-15T00:00:00.000Z,1463,6674970,71.78,3161,6023330,64.77,3850,4398495,47.3,5713,529928,5.7,62.12,8.21,29.66
2022-01-16T00:00:00.000Z,3821,6678791,71.82,8518,6031848,64.86,7653,4406148,47.38,19997,549925,5.91,62.26,8.14,29.6
2022-01-17T00:00:00.000Z,2810,6681601,71.85,7040,6038888,64.94,6134,4412282,47.45,17833,567758,6.11,62.4,8.06,29.54
2022-01-18T00:00:00.000Z,2476,6684077,71.88,7368,6046256,65.02,5479,4417761,47.51,14843,582601,6.27,62.53,8,29.47
2022-01-19T00:00:00.000Z,1887,6685964,71.9,6358,6052614,65.09,4474,4422235,47.55,8444,591045,6.36,62.7,7.89,29.41
2022-01-20T00:00:00.000Z,1780,6687744,71.92,6956,6059570,65.16,4761,4426996,47.61,8034,599079,6.44,62.8,7.85,29.35
2022-01-21T00:00:00.000Z,900,6688644,71.93,3722,6063292,65.2,2601,4429597,47.63,3350,602429,6.48,62.92,7.77,29.32
2022-01-22T00:00:00.000Z,329,6688973,71.93,1456,6064748,65.22,1042,4430639,47.64,1110,603539,6.49,63,7.71,29.29
2022-01-23T00:00:00.000Z,1064,6690037,71.94,5623,6070371,65.28,2859,4433498,47.68,6082,609621,6.56,63.13,7.63,29.24
2022-01-24T00:00:00.000Z,755,6690792,71.95,4480,6074851,65.33,2236,4435734,47.7,5057,614678,6.61,63.22,7.58,29.2
2022-01-25T00:00:00.000Z,741,6691533,71.96,4395,6079246,65.37,2154,4437888,47.72,7090,621768,6.69,63.28,7.56,29.17
2022-01-26T00:00:00.000Z,614,6692147,71.96,3279,6082525,65.41,1584,4439472,47.74,4258,626026,6.73,63.37,7.5,29.13
2022-01-27T00:00:00.000Z,792,6692939,71.97,4401,6086926,65.46,1970,4441442,47.76,5432,631458,6.79,63.45,7.46,29.09
2022-01-28T00:00:00.000Z,393,6693332,71.98,2370,6089296,65.48,1139,4442581,47.77,3441,634899,6.83,63.49,7.44,29.06
2022-01-29T00:00:00.000Z,124,6693456,71.98,1037,6090333,65.49,403,4442984,47.78,1160,636059,6.84,63.57,7.39,29.05
2022-01-30T00:00:00.000Z,772,6694228,71.99,4713,6095046,65.54,2002,4444986,47.8,8093,644152,6.93,63.66,7.32,29.01
2022-01-31T00:00:00.000Z,528,6694756,71.99,3181,6098227,65.58,1585,4446571,47.82,6461,650613,7,63.84,7.19,28.98
2022-02-01T00:00:00.000Z,475,6695231,72,2776,6101003,65.61,1492,4448063,47.83,5709,656322,7.06,63.87,7.18,28.95
2022-02-02T00:00:00.000Z,374,6695605,72,2382,6103385,65.63,1351,4449414,47.85,5052,661374,7.11,63.88,7.19,28.93
2022-02-03T00:00:00.000Z,443,6696048,72.01,2774,6106159,65.66,1426,4450840,47.86,5596,666970,7.17,63.91,7.18,28.91
2022-02-04T00:00:00.000Z,175,6696223,72.01,985,6107144,65.67,726,4451566,47.87,2444,669414,7.2,63.94,7.17,28.89
2022-02-05T00:00:00.000Z,59,6696282,72.01,337,6107481,65.68,203,4451769,47.87,418,669832,7.2,63.91,7.2,28.89
2022-02-06T00:00:00.000Z,407,6696689,72.01,2315,6109796,65.7,1329,4453098,47.89,5673,675505,7.26,63.98,7.16,28.86
2022-02-07T00:00:00.000Z,279,6696968,72.02,1305,6111101,65.72,952,4454050,47.9,5945,681450,7.33,64.04,7.12,28.84
2022-02-08T00:00:00.000Z,311,6697279,72.02,1495,6112596,65.73,1037,4455087,47.91,6125,687575,7.39,64.09,7.09,28.83
2022-02-09T00:00:00.000Z,243,6697522,72.02,1091,6113687,65.74,917,4456004,47.92,4570,692145,7.44,64.12,7.07,28.81
2022-02-10T00:00:00.000Z,268,6697790,72.02,1289,6114976,65.76,916,4456920,47.93,4810,696955,7.49,64.15,7.05,28.8
2022-02-11T00:00:00.000Z,181,6697971,72.03,535,6115511,65.76,501,4457421,47.93,2525,699480,7.52,64.19,7.02,28.79
2022-02-12T00:00:00.000Z,26,6697997,72.03,89,6115600,65.76,109,4457530,47.93,262,699742,7.52,64.2,7.02,28.79
2022-02-13T00:00:00.000Z,286,6698283,72.03,947,6116547,65.77,958,4458488,47.94,4991,704733,7.58,64.24,6.98,28.78
2022-02-14T00:00:00.000Z,179,6698462,72.03,621,6117168,65.78,734,4459222,47.95,3128,707861,7.61,64.31,6.92,28.77
2022-02-15T00:00:00.000Z,265,6698727,72.03,762,6117930,65.79,909,4460131,47.96,3806,711667,7.65,64.34,6.91,28.76
2022-02-16T00:00:00.000Z,180,6698907,72.04,575,6118505,65.8,782,4460913,47.97,2477,714144,7.68,64.35,6.9,28.75
2022-02-17T00:00:00.000Z,247,6699154,72.04,735,6119240,65.8,753,4461666,47.98,3047,717191,7.71,64.37,6.89,28.74
2022-02-18T00:00:00.000Z,128,6699282,72.04,320,6119560,65.81,422,4462088,47.98,1114,718305,7.72,64.39,6.87,28.74
2022-02-19T00:00:00.000Z,17,6699299,72.04,80,6119640,65.81,70,4462158,47.98,74,718379,7.73,64.39,6.87,28.74
2022-02-20T00:00:00.000Z,204,6699503,72.04,604,6120244,65.81,711,4462869,47.99,2564,720943,7.75,64.42,6.85,28.73
2022-02-21T00:00:00.000Z,168,6699671,72.05,406,6120650,65.82,466,4463335,48,1534,722477,7.77,64.44,6.83,28.72
2022-02-22T00:00:00.000Z,155,6699826,72.05,451,6121101,65.82,553,4463888,48,1860,724337,7.79,64.45,6.83,28.72
2022-02-23T00:00:00.000Z,109,6699935,72.05,350,6121451,65.83,443,4464331,48.01,1148,725485,7.8,64.45,6.84,28.71
2022-02-24T00:00:00.000Z,137,6700072,72.05,452,6121903,65.83,552,4464883,48.01,1485,726970,7.82,64.44,6.85,28.71
2022-02-25T00:00:00.000Z,55,6700127,72.05,137,6122040,65.83,182,4465065,48.02,451,727421,7.82,64.44,6.85,28.71
2022-02-26T00:00:00.000Z,15,6700142,72.05,26,6122066,65.83,147,4465212,48.02,34,727455,7.82,64.43,6.86,28.71
2022-02-27T00:00:00.000Z,109,6700251,72.05,338,6122404,65.84,444,4465656,48.02,1119,728574,7.83,64.44,6.86,28.7
2022-02-28T00:00:00.000Z,109,6700360,72.05,262,6122666,65.84,406,4466062,48.03,901,729475,7.84,64.45,6.85,28.7
2022-03-01T00:00:00.000Z,92,6700452,72.05,277,6122943,65.84,357,4466419,48.03,788,730263,7.85,64.44,6.86,28.7
2022-03-02T00:00:00.000Z,75,6700527,72.05,199,6123142,65.85,315,4466734,48.03,690,730953,7.86,64.43,6.87,28.69
2022-03-03T00:00:00.000Z,148,6700675,72.06,366,6123508,65.85,482,4467216,48.04,986,731939,7.87,64.43,6.88,28.69
2022-03-04T00:00:00.000Z,48,6700723,72.06,126,6123634,65.85,157,4467373,48.04,228,732167,7.87,64.42,6.89,28.69
2022-03-05T00:00:00.000Z,1,6700724,72.06,23,6123657,65.85,38,4467411,48.04,29,732196,7.87,64.41,6.9,28.69
2022-03-06T00:00:00.000Z,92,6700816,72.06,258,6123915,65.85,408,4467819,48.04,760,732956,7.88,64.41,6.91,28.69
2022-03-07T00:00:00.000Z,89,6700905,72.06,255,6124170,65.86,341,4468160,48.05,602,733558,7.89,64.41,6.9,28.68
2022-03-08T00:00:00.000Z,100,6701005,72.06,264,6124434,65.86,328,4468488,48.05,541,734099,7.89,64.4,6.92,28.68
2022-03-09T00:00:00.000Z,85,6701090,72.06,212,6124646,65.86,326,4468814,48.06,488,734587,7.9,64.38,6.94,28.68
2022-03-10T00:00:00.000Z,111,6701201,72.06,362,6125008,65.87,417,4469231,48.06,614,735201,7.91,64.36,6.96,28.68
2022-03-11T00:00:00.000Z,24,6701225,72.06,85,6125093,65.87,113,4469344,48.06,141,735342,7.91,64.35,6.98,28.68
2022-03-12T00:00:00.000Z,6,6701231,72.06,9,6125102,65.87,25,4469369,48.06,22,735364,7.91,64.33,7,28.67
2022-03-13T00:00:00.000Z,92,6701323,72.06,272,6125374,65.87,354,4469723,48.07,589,735953,7.91,64.32,7.01,28.67
2022-03-14T00:00:00.000Z,62,6701385,72.06,249,6125623,65.87,308,4470031,48.07,556,736509,7.92,64.32,7.01,28.67
2022-03-15T00:00:00.000Z,81,6701466,72.06,180,6125803,65.87,279,4470310,48.07,579,737088,7.93,64.3,7.03,28.67
2022-03-16T00:00:00.000Z,73,6701539,72.06,205,6126008,65.88,298,4470608,48.07,665,737753,7.93,64.29,7.04,28.67
2022-03-17T00:00:00.000Z,63,6701602,72.07,120,6126128,65.88,279,4470887,48.08,601,738354,7.94,64.29,7.04,28.67
2022-03-18T00:00:00.000Z,18,6701620,72.07,52,6126180,65.88,96,4470983,48.08,225,738579,7.94,64.29,7.04,28.66
2022-03-19T00:00:00.000Z,5,6701625,72.07,10,6126190,65.88,24,4471007,48.08,35,738614,7.94,64.24,7.1,28.66
2022-03-20T00:00:00.000Z,116,6701741,72.07,254,6126444,65.88,477,4471484,48.08,1426,740040,7.96,64.22,7.11,28.66
2022-03-21T00:00:00.000Z,97,6701838,72.07,241,6126685,65.88,367,4471851,48.09,1119,741159,7.97,64.22,7.12,28.66
2022-03-22T00:00:00.000Z,142,6701980,72.07,340,6127025,65.89,490,4472341,48.09,1763,742922,7.99,64.18,7.16,28.66
2022-03-23T00:00:00.000Z,108,6702088,72.07,207,6127232,65.89,446,4472787,48.1,1666,744588,8.01,64.15,7.19,28.66
2022-03-24T00:00:00.000Z,174,6702262,72.07,334,6127566,65.89,745,4473532,48.11,2348,746936,8.03,64.13,7.21,28.66
2022-03-25T00:00:00.000Z,35,6702297,72.07,75,6127641,65.89,149,4473681,48.11,618,747554,8.04,64.13,7.22,28.66
2022-03-26T00:00:00.000Z,11,6702308,72.07,11,6127652,65.89,31,4473712,48.11,88,747642,8.04,64.13,7.22,28.66
2022-03-27T00:00:00.000Z,157,6702465,72.08,332,6127984,65.9,756,4474468,48.12,3181,750823,8.07,64.11,7.24,28.65
2022-03-28T00:00:00.000Z,114,6702579,72.08,267,6128251,65.9,610,4475078,48.12,2392,753215,8.1,64.1,7.24,28.65
2022-03-29T00:00:00.000Z,88,6702667,72.08,187,6128438,65.9,465,4475543,48.13,2209,755424,8.12,64.06,7.29,28.65
