Day_Date,vaccinated,vaccinated_cum,vaccinated_population_perc,vaccinated_seconde_dose,vaccinated_seconde_dose_cum,vaccinated_seconde_dose_population_perc,vaccinated_third_dose,vaccinated_third_dose_cum,vaccinated_third_dose_population_perc,vaccinated_fourth_dose,vaccinated_fourth_dose_cum,vaccinated_fourth_dose_population_perc,vaccinated_validity_perc,vaccinated_expired_perc,not_vaccinated_perc
2020-12-19T00:00:00.000Z,46,66,0,0,4,0,0,0,0,0,0,0,0,0,100
2020-12-20T00:00:00.000Z,7390,7456,0.08,0,4,0,0,0,0,0,0,0,0,0,100
2020-12-21T00:00:00.000Z,24917,32373,0.35,0,4,0,0,0,0,0,0,0,0,0,100
2020-12-22T00:00:00.000Z,44653,77026,0.83,0,4,0,0,0,0,0,0,0,0,0,100
2020-12-23T00:00:00.000Z,62900,139926,1.5,0,4,0,0,0,0,0,0,0,0,0,100
2020-12-24T00:00:00.000Z,73411,213337,2.29,0,4,0,0,0,0,0,0,0,0,0,100
2020-12-25T00:00:00.000Z,38505,251842,2.71,0,4,0,0,0,0,0,0,0,0,0,100
2020-12-26T00:00:00.000Z,32608,284450,3.06,0,4,0,0,0,0,0,0,0,0,0,100
2020-12-27T00:00:00.000Z,104543,388993,4.18,0,4,0,0,0,0,0,0,0,0,0,100
2020-12-28T00:00:00.000Z,134989,523982,5.63,0,4,0,0,0,0,0,0,0,0,0,100
2020-12-29T00:00:00.000Z,156256,680238,7.31,2,6,0,0,0,0,0,0,0,0,0,100
2020-12-30T00:00:00.000Z,153106,833344,8.96,0,6,0,0,0,0,0,0,0,0,0,100
2020-12-31T00:00:00.000Z,158510,991854,10.67,0,6,0,0,0,0,0,0,0,0,0,100
2021-01-01T00:00:00.000Z,71403,1063257,11.43,0,6,0,0,0,0,0,0,0,0,0,100
2021-01-02T00:00:00.000Z,71708,1134965,12.2,0,6,0,0,0,0,0,0,0,0,0,100
2021-01-03T00:00:00.000Z,149697,1284662,13.81,0,6,0,0,0,0,0,0,0,0,0,100
2021-01-04T00:00:00.000Z,152142,1436804,15.45,1,7,0,0,0,0,0,0,0,0,0,100
2021-01-05T00:00:00.000Z,125139,1561943,16.8,3,10,0,0,0,0,0,0,0,0,0,100
2021-01-06T00:00:00.000Z,103292,1665235,17.91,2,12,0,0,0,0,0,0,0,0,0,100
2021-01-07T00:00:00.000Z,115991,1781226,19.15,7,19,0,0,0,0,0,0,0,0,0,100
2021-01-08T00:00:00.000Z,66421,1847647,19.87,4,23,0,0,0,0,0,0,0,0,0,100
2021-01-09T00:00:00.000Z,44518,1892165,20.35,24,47,0,0,0,0,0,0,0,0,0,100
2021-01-10T00:00:00.000Z,37629,1929794,20.75,5997,6044,0.07,0,0,0,0,0,0,0,0,100
2021-01-11T00:00:00.000Z,21141,1950935,20.98,19259,25303,0.27,0,0,0,0,0,0,0,0,100
2021-01-12T00:00:00.000Z,24038,1974973,21.24,35666,60969,0.66,0,0,0,0,0,0,0,0,100
2021-01-13T00:00:00.000Z,52032,2027005,21.8,56861,117830,1.27,0,0,0,0,0,0,0,0,100
2021-01-14T00:00:00.000Z,56427,2083432,22.4,68825,186655,2.01,0,0,0,0,0,0,0,0,100
2021-01-15T00:00:00.000Z,30743,2114175,22.73,35927,222582,2.39,0,0,0,0,0,0,0,0,100
2021-01-16T00:00:00.000Z,29451,2143626,23.05,26003,248585,2.67,0,0,0,0,0,0,0,0,100
2021-01-17T00:00:00.000Z,68405,2212031,23.79,84579,333164,3.58,0,0,0,0,0,0,0.36,0,99.64
2021-01-18T00:00:00.000Z,69760,2281791,24.54,120402,453566,4.88,0,0,0,0,0,0,0.64,0,99.36
2021-01-19T00:00:00.000Z,72848,2354639,25.32,137807,591373,6.36,0,0,0,0,0,0,1.16,0,98.84
2021-01-20T00:00:00.000Z,76851,2431490,26.15,143717,735090,7.9,0,0,0,0,0,0,1.98,0,98.02
2021-01-21T00:00:00.000Z,69955,2501445,26.9,164393,899483,9.67,0,0,0,0,0,0,2.98,0,97.02
2021-01-22T00:00:00.000Z,37890,2539335,27.31,71108,970591,10.44,0,0,0,0,0,0,3.5,0,96.5
2021-01-23T00:00:00.000Z,39948,2579283,27.74,53568,1024159,11.01,0,0,0,0,0,0,3.89,0,96.11
2021-01-24T00:00:00.000Z,69098,2648381,28.48,140661,1164820,12.53,0,0,0,0,0,0,5.1,0,94.9
2021-01-25T00:00:00.000Z,80893,2729274,29.35,139478,1304298,14.03,0,0,0,0,0,0,6.78,0,93.22
2021-01-26T00:00:00.000Z,78682,2807956,30.2,126386,1430684,15.38,0,0,0,0,0,0,8.65,0,91.35
2021-01-27T00:00:00.000Z,77929,2885885,31.03,125018,1555702,16.73,0,0,0,0,0,0,10.56,0,89.44
2021-01-28T00:00:00.000Z,79530,2965415,31.89,130575,1686277,18.13,0,0,0,0,0,0,12.69,0,87.31
2021-01-29T00:00:00.000Z,36666,3002081,32.28,64767,1751044,18.83,0,0,0,0,0,0,13.61,0,86.39
2021-01-30T00:00:00.000Z,34383,3036464,32.65,42748,1793792,19.29,0,0,0,0,0,0,14.3,0,85.7
2021-01-31T00:00:00.000Z,73310,3109774,33.44,59479,1853271,19.93,0,0,0,0,0,0,16.07,0,83.93
2021-02-01T00:00:00.000Z,82467,3192241,34.33,35325,1888596,20.31,0,0,0,0,0,0,17.81,0,82.19
2021-02-02T00:00:00.000Z,70056,3262297,35.08,31047,1919643,20.64,0,0,0,0,0,0,19.35,0,80.65
2021-02-03T00:00:00.000Z,60272,3322569,35.73,51412,1971055,21.2,0,0,0,0,0,0,20.84,0,79.16
2021-02-04T00:00:00.000Z,72594,3395163,36.51,58066,2029121,21.82,0,0,0,0,0,0,22.39,0,77.61
2021-02-05T00:00:00.000Z,33910,3429073,36.87,28781,2057902,22.13,0,0,0,0,0,0,23.15,0,76.85
2021-02-06T00:00:00.000Z,21600,3450673,37.11,22221,2080123,22.37,0,0,0,0,0,0,23.64,0,76.36
2021-02-07T00:00:00.000Z,54065,3504738,37.69,68707,2148830,23.11,0,0,0,0,0,0,24.4,0,75.6
2021-02-08T00:00:00.000Z,58609,3563347,38.32,65438,2214268,23.81,0,0,0,0,0,0,24.95,0,75.05
2021-02-09T00:00:00.000Z,66309,3629656,39.03,67535,2281803,24.54,0,0,0,0,0,0,25.48,0,74.52
2021-02-10T00:00:00.000Z,70526,3700182,39.79,72271,2354074,25.31,0,0,0,0,0,0,26.23,0,73.77
2021-02-11T00:00:00.000Z,81138,3781320,40.66,72072,2426146,26.09,0,0,0,0,0,0,27.08,0,72.92
2021-02-12T00:00:00.000Z,39077,3820397,41.08,37562,2463708,26.49,0,0,0,0,0,0,27.5,0,72.5
2021-02-13T00:00:00.000Z,27448,3847845,41.38,30423,2494131,26.82,0,0,0,0,0,0,27.82,0,72.18
2021-02-14T00:00:00.000Z,74882,3922727,42.18,69054,2563185,27.56,0,0,0,0,0,0,28.76,0,71.24
2021-02-15T00:00:00.000Z,81509,4004236,43.06,75674,2638859,28.38,0,0,0,0,0,0,29.69,0,70.31
2021-02-16T00:00:00.000Z,83392,4087628,43.96,78252,2717111,29.22,0,0,0,0,0,0,30.64,0,69.36
2021-02-17T00:00:00.000Z,61951,4149579,44.62,75600,2792711,30.03,0,0,0,0,0,0,31.56,0,68.44
2021-02-18T00:00:00.000Z,69124,4218703,45.37,79711,2872422,30.89,0,0,0,0,0,0,32.51,0,67.49
2021-02-19T00:00:00.000Z,39646,4258349,45.79,38128,2910550,31.3,0,0,0,0,0,0,33.02,0,66.98
2021-02-20T00:00:00.000Z,31643,4289992,46.13,28716,2939266,31.61,0,0,0,0,0,0,33.43,0,66.57
2021-02-21T00:00:00.000Z,79411,4369403,46.99,78422,3017688,32.45,0,0,0,0,0,0,34.39,0,65.61
2021-02-22T00:00:00.000Z,85031,4454434,47.9,80575,3098263,33.32,0,0,0,0,0,0,35.44,0,64.56
2021-02-23T00:00:00.000Z,77305,4531739,48.73,70449,3168712,34.07,0,0,0,0,0,0,36.47,0,63.53
2021-02-24T00:00:00.000Z,61036,4592775,49.39,63104,3231816,34.75,0,0,0,0,0,0,37.4,0,62.6
2021-02-25T00:00:00.000Z,51698,4644473,49.94,64775,3296591,35.45,0,0,0,0,0,0,38.31,0,61.69
2021-02-26T00:00:00.000Z,25887,4670360,50.22,32014,3328605,35.79,0,0,0,0,0,0,38.76,0,61.24
2021-02-27T00:00:00.000Z,18333,4688693,50.42,21186,3349791,36.02,0,0,0,0,0,0,39.08,0,60.92
2021-02-28T00:00:00.000Z,40335,4729028,50.85,55858,3405649,36.62,0,0,0,0,0,0,39.92,0,60.08
2021-03-01T00:00:00.000Z,45709,4774737,51.35,61413,3467062,37.28,0,0,0,0,0,0,40.78,0,59.22
2021-03-02T00:00:00.000Z,41155,4815892,51.79,64762,3531824,37.98,0,0,0,0,0,0,41.54,0,58.46
2021-03-03T00:00:00.000Z,41991,4857883,52.24,66749,3598573,38.7,0,0,0,0,0,0,42.25,0,57.75
2021-03-04T00:00:00.000Z,39679,4897562,52.67,79095,3677668,39.55,0,0,0,0,0,0,42.95,0,57.05
2021-03-05T00:00:00.000Z,17329,4914891,52.85,40445,3718113,39.98,0,0,0,0,0,0,43.28,0,56.72
2021-03-06T00:00:00.000Z,10696,4925587,52.97,25337,3743450,40.26,0,0,0,0,0,0,43.5,0,56.5
2021-03-07T00:00:00.000Z,31125,4956712,53.3,72821,3816271,41.04,0,0,0,0,0,0,44.09,0,55.91
2021-03-08T00:00:00.000Z,27345,4984057,53.6,73263,3889534,41.83,0,0,0,0,0,0,44.71,0,55.29
2021-03-09T00:00:00.000Z,26716,5010773,53.88,76578,3966112,42.65,0,0,0,0,0,0,45.37,0,54.63
2021-03-10T00:00:00.000Z,23319,5034092,54.13,58653,4024765,43.28,0,0,0,0,0,0,46.03,0,53.97
2021-03-11T00:00:00.000Z,23270,5057362,54.38,69065,4093830,44.02,0,0,0,0,0,0,46.76,0,53.24
2021-03-12T00:00:00.000Z,11247,5068609,54.51,41395,4135225,44.47,0,0,0,0,0,0,47.12,0,52.88
2021-03-13T00:00:00.000Z,7925,5076534,54.59,25233,4160458,44.74,0,0,0,0,0,0,47.35,0,52.65
2021-03-14T00:00:00.000Z,20949,5097483,54.82,73922,4234380,45.53,0,0,0,0,0,0,47.99,0,52.01
2021-03-15T00:00:00.000Z,20110,5117593,55.03,78249,4312629,46.38,0,0,0,0,0,0,48.61,0,51.39
2021-03-16T00:00:00.000Z,18721,5136314,55.23,71454,4384083,47.14,0,0,0,0,0,0,49.23,0,50.77
2021-03-17T00:00:00.000Z,17664,5153978,55.42,58984,4443067,47.78,0,0,0,0,0,0,49.72,0,50.28
2021-03-18T00:00:00.000Z,16013,5169991,55.6,58106,4501173,48.4,0,0,0,0,0,0,50.26,0,49.74
2021-03-19T00:00:00.000Z,6919,5176910,55.67,27963,4529136,48.7,0,0,0,0,0,0,50.56,0,49.44
2021-03-20T00:00:00.000Z,5205,5182115,55.73,15287,4544423,48.87,0,0,0,0,0,0,50.74,0,49.26
2021-03-21T00:00:00.000Z,13141,5195256,55.87,40481,4584904,49.3,0,0,0,0,0,0,51.27,0,48.73
2021-03-22T00:00:00.000Z,13545,5208801,56.01,40512,4625416,49.74,0,0,0,0,0,0,51.81,0,48.19
2021-03-23T00:00:00.000Z,2807,5211608,56.04,7276,4632692,49.82,0,0,0,0,0,0,52.24,0,47.76
2021-03-24T00:00:00.000Z,10980,5222588,56.16,46526,4679218,50.32,0,0,0,0,0,0,52.65,0,47.35
2021-03-25T00:00:00.000Z,10226,5232814,56.27,35405,4714623,50.7,0,0,0,0,0,0,53.04,0,46.96
2021-03-26T00:00:00.000Z,4159,5236973,56.32,13313,4727936,50.84,0,0,0,0,0,0,53.22,0,46.78
2021-03-27T00:00:00.000Z,1770,5238743,56.33,4255,4732191,50.89,0,0,0,0,0,0,53.31,0,46.69
2021-03-28T00:00:00.000Z,2096,5240839,56.36,4598,4736789,50.94,0,0,0,0,0,0,53.55,0,46.45
2021-03-29T00:00:00.000Z,6884,5247723,56.43,29994,4766783,51.26,0,0,0,0,0,0,53.81,0,46.19
2021-03-30T00:00:00.000Z,7850,5255573,56.52,22414,4789197,51.5,0,0,0,0,0,0,53.9,0,46.1
2021-03-31T00:00:00.000Z,8120,5263693,56.6,19452,4808649,51.71,0,0,0,0,0,0,54.2,0,45.8
2021-04-01T00:00:00.000Z,8160,5271853,56.69,18671,4827320,51.91,0,0,0,0,0,0,54.43,0,45.57
2021-04-02T00:00:00.000Z,2911,5274764,56.72,8109,4835429,52,0,0,0,0,0,0,54.52,0,45.48
2021-04-03T00:00:00.000Z,1411,5276175,56.74,2956,4838385,52.03,0,0,0,0,0,0,54.55,0,45.45
2021-04-04T00:00:00.000Z,9609,5285784,56.84,22814,4861199,52.27,0,0,0,0,0,0,54.64,0,45.36
2021-04-05T00:00:00.000Z,10323,5296107,56.95,21235,4882434,52.5,0,0,0,0,0,0,54.86,0,45.14
2021-04-06T00:00:00.000Z,8992,5305099,57.05,16756,4899190,52.68,0,0,0,0,0,0,55.03,0,44.97
2021-04-07T00:00:00.000Z,8890,5313989,57.14,15267,4914457,52.85,0,0,0,0,0,0,55.18,0,44.82
2021-04-08T00:00:00.000Z,9381,5323370,57.24,16975,4931432,53.03,0,0,0,0,0,0,55.34,0,44.66
2021-04-09T00:00:00.000Z,3573,5326943,57.28,6212,4937644,53.1,0,0,0,0,0,0,55.4,0,44.6
2021-04-10T00:00:00.000Z,1614,5328557,57.3,3502,4941146,53.13,0,0,0,0,0,0,55.43,0,44.57
2021-04-11T00:00:00.000Z,9015,5337572,57.4,14220,4955366,53.29,0,0,0,0,0,0,55.61,0,44.39
2021-04-12T00:00:00.000Z,8904,5346476,57.49,13205,4968571,53.43,0,0,0,0,0,0,55.77,0,44.23
2021-04-13T00:00:00.000Z,5802,5352278,57.56,4926,4973497,53.48,0,0,0,0,0,0,55.9,0,44.1
2021-04-14T00:00:00.000Z,3612,5355890,57.59,5277,4978774,53.54,0,0,0,0,0,0,56,0,44
2021-04-15T00:00:00.000Z,668,5356558,57.6,555,4979329,53.55,0,0,0,0,0,0,56.1,0,43.9
2021-04-16T00:00:00.000Z,3378,5359936,57.64,6623,4985952,53.62,0,0,0,0,0,0,56.15,0,43.85
2021-04-17T00:00:00.000Z,804,5360740,57.65,1958,4987910,53.64,0,0,0,0,0,0,56.17,0,43.83
2021-04-18T00:00:00.000Z,7083,5367823,57.72,7418,4995328,53.72,0,0,0,0,0,0,56.29,0,43.71
2021-04-19T00:00:00.000Z,6373,5374196,57.79,7098,5002426,53.79,0,0,0,0,0,0,56.4,0,43.6
2021-04-20T00:00:00.000Z,6246,5380442,57.86,6850,5009276,53.87,0,0,0,0,0,0,56.47,0,43.53
2021-04-21T00:00:00.000Z,6346,5386788,57.93,7072,5016348,53.94,0,0,0,0,0,0,56.54,0,43.46
2021-04-22T00:00:00.000Z,5917,5392705,57.99,7662,5024010,54.03,0,0,0,0,0,0,56.58,0,43.42
2021-04-23T00:00:00.000Z,2738,5395443,58.02,3362,5027372,54.06,0,0,0,0,0,0,56.63,0,43.37
2021-04-24T00:00:00.000Z,754,5396197,58.03,1276,5028648,54.08,0,0,0,0,0,0,56.64,0,43.36
2021-04-25T00:00:00.000Z,4817,5401014,58.08,6906,5035554,54.15,0,0,0,0,0,0,56.71,0,43.29
2021-04-26T00:00:00.000Z,5457,5406471,58.14,7867,5043421,54.23,0,0,0,0,0,0,56.79,0,43.21
2021-04-27T00:00:00.000Z,4485,5410956,58.19,6600,5050021,54.31,0,0,0,0,0,0,56.85,0,43.15
2021-04-28T00:00:00.000Z,4464,5415420,58.23,7286,5057307,54.38,0,0,0,0,0,0,56.92,0,43.08
2021-04-29T00:00:00.000Z,4341,5419761,58.28,7250,5064557,54.46,0,0,0,0,0,0,56.99,0,43.01
2021-04-30T00:00:00.000Z,1900,5421661,58.3,3161,5067718,54.5,0,0,0,0,0,0,57.02,0,42.98
2021-05-01T00:00:00.000Z,445,5422106,58.31,885,5068603,54.51,0,0,0,0,0,0,57.03,0,42.97
2021-05-02T00:00:00.000Z,3215,5425321,58.34,6067,5074670,54.57,0,0,0,0,0,0,57.08,0,42.92
2021-05-03T00:00:00.000Z,3525,5428846,58.38,5791,5080461,54.63,0,0,0,0,0,0,57.15,0,42.85
2021-05-04T00:00:00.000Z,3560,5432406,58.42,4701,5085162,54.68,0,0,0,0,0,0,57.2,0,42.8
2021-05-05T00:00:00.000Z,3267,5435673,58.45,4055,5089217,54.73,0,0,0,0,0,0,57.26,0,42.74
2021-05-06T00:00:00.000Z,3614,5439287,58.49,3101,5092318,54.76,0,0,0,0,0,0,57.32,0,42.68
2021-05-07T00:00:00.000Z,1806,5441093,58.51,2473,5094791,54.79,0,0,0,0,0,0,57.35,0,42.65
2021-05-08T00:00:00.000Z,230,5441323,58.51,492,5095283,54.79,0,0,0,0,0,0,57.35,0,42.65
2021-05-09T00:00:00.000Z,2836,5444159,58.54,4735,5100018,54.84,0,0,0,0,0,0,57.4,0,42.6
2021-05-10T00:00:00.000Z,2879,5447038,58.57,4679,5104697,54.89,0,0,0,0,0,0,57.45,0,42.55
2021-05-11T00:00:00.000Z,2602,5449640,58.6,3851,5108548,54.93,0,0,0,0,0,0,57.49,0,42.51
2021-05-12T00:00:00.000Z,1996,5451636,58.62,3307,5111855,54.97,0,0,0,0,0,0,57.53,0,42.47
2021-05-13T00:00:00.000Z,2025,5453661,58.65,3647,5115502,55.01,0,0,0,0,0,0,57.56,0,42.44
2021-05-14T00:00:00.000Z,950,5454611,58.66,1469,5116971,55.03,0,0,0,0,0,0,57.57,0,42.43
2021-05-15T00:00:00.000Z,236,5454847,58.66,237,5117208,55.03,0,0,0,0,0,0,57.58,0,42.42
2021-05-16T00:00:00.000Z,522,5455369,58.66,1196,5118404,55.04,0,0,0,0,0,0,57.6,0,42.4
2021-05-17T00:00:00.000Z,286,5455655,58.67,829,5119233,55.05,0,0,0,0,0,0,57.63,0,42.37
2021-05-18T00:00:00.000Z,1943,5457598,58.69,4920,5124153,55.1,0,0,0,0,0,0,57.66,0,42.34
2021-05-19T00:00:00.000Z,2204,5459802,58.71,5017,5129170,55.16,0,0,0,0,0,0,57.69,0,42.31
2021-05-20T00:00:00.000Z,2295,5462097,58.74,3857,5133027,55.2,0,0,0,0,0,0,57.72,0,42.28
2021-05-21T00:00:00.000Z,1163,5463260,58.75,1379,5134406,55.21,0,0,0,0,0,0,57.74,0,42.26
2021-05-22T00:00:00.000Z,203,5463463,58.75,382,5134788,55.22,0,0,0,0,0,0,57.74,0,42.26
2021-05-23T00:00:00.000Z,2266,5465729,58.78,3208,5137996,55.25,0,0,0,0,0,0,57.76,0,42.24
2021-05-24T00:00:00.000Z,2111,5467840,58.8,3578,5141574,55.29,0,0,0,0,0,0,57.78,0,42.22
2021-05-25T00:00:00.000Z,1805,5469645,58.82,2567,5144141,55.32,0,0,0,0,0,0,57.81,0,42.19
2021-05-26T00:00:00.000Z,1389,5471034,58.83,2475,5146616,55.34,0,0,0,0,0,0,57.85,0,42.15
2021-05-27T00:00:00.000Z,1824,5472858,58.85,3160,5149776,55.38,0,0,0,0,0,0,57.88,0,42.12
2021-05-28T00:00:00.000Z,755,5473613,58.86,1383,5151159,55.39,0,0,0,0,0,0,57.89,0,42.11
2021-05-29T00:00:00.000Z,170,5473783,58.86,215,5151374,55.4,0,0,0,0,0,0,57.89,0,42.11
2021-05-30T00:00:00.000Z,1630,5475413,58.88,1921,5153295,55.42,0,0,0,0,0,0,57.92,0,42.08
2021-05-31T00:00:00.000Z,1710,5477123,58.9,2077,5155372,55.44,0,0,0,0,0,0,57.95,0,42.05
2021-06-01T00:00:00.000Z,1351,5478474,58.91,1804,5157176,55.46,0,0,0,0,0,0,57.97,0,42.03
2021-06-02T00:00:00.000Z,1482,5479956,58.93,1589,5158765,55.47,0,0,0,0,0,0,57.99,0,42.01
2021-06-03T00:00:00.000Z,1656,5481612,58.95,1468,5160233,55.49,0,0,0,0,0,0,58.01,0,41.99
2021-06-04T00:00:00.000Z,1068,5482680,58.96,761,5160994,55.5,0,0,0,0,0,0,58.03,0,41.97
2021-06-05T00:00:00.000Z,171,5482851,58.96,148,5161142,55.5,0,0,0,0,0,0,58.03,0,41.97
2021-06-06T00:00:00.000Z,4275,5487126,59.01,986,5162128,55.51,0,0,0,0,0,0,58.07,0,41.93
2021-06-07T00:00:00.000Z,4408,5491534,59.05,789,5162917,55.52,0,0,0,0,0,0,58.1,0,41.9
2021-06-08T00:00:00.000Z,3716,5495250,59.09,1149,5164066,55.53,0,0,0,0,0,0,58.14,0,41.86
2021-06-09T00:00:00.000Z,3571,5498821,59.13,1297,5165363,55.55,0,0,0,0,0,0,58.17,0,41.83
2021-06-10T00:00:00.000Z,3323,5502144,59.17,1273,5166636,55.56,0,0,0,0,0,0,58.2,0,41.8
2021-06-11T00:00:00.000Z,1370,5503514,59.18,564,5167200,55.57,0,0,0,0,0,0,58.21,0,41.79
2021-06-12T00:00:00.000Z,203,5503717,59.18,158,5167358,55.57,0,0,0,0,0,0,58.21,0,41.79
2021-06-13T00:00:00.000Z,3093,5506810,59.22,1244,5168602,55.58,0,0,0,0,0,0,58.24,0,41.76
2021-06-14T00:00:00.000Z,3029,5509839,59.25,1511,5170113,55.6,0,0,0,0,0,0,58.26,0,41.74
2021-06-15T00:00:00.000Z,3119,5512958,59.28,1351,5171464,55.61,0,0,0,0,0,0,58.28,0,41.72
2021-06-16T00:00:00.000Z,2701,5515659,59.31,975,5172439,55.62,0,0,0,0,0,0,58.31,0,41.69
2021-06-17T00:00:00.000Z,2704,5518363,59.34,1176,5173615,55.63,0,0,0,0,0,0,58.33,0,41.67
2021-06-18T00:00:00.000Z,1241,5519604,59.36,477,5174092,55.64,0,0,0,0,0,0,58.34,0,41.66
2021-06-19T00:00:00.000Z,216,5519820,59.36,132,5174224,55.64,0,0,0,0,0,0,58.34,0,41.66
2021-06-20T00:00:00.000Z,3301,5523121,59.39,1314,5175538,55.66,0,0,0,0,0,0,58.37,0,41.63
2021-06-21T00:00:00.000Z,5227,5528348,59.45,1191,5176729,55.67,0,0,0,0,0,0,58.41,0,41.59
2021-06-22T00:00:00.000Z,6901,5535249,59.52,1079,5177808,55.68,0,0,0,0,0,0,58.46,0,41.54
2021-06-23T00:00:00.000Z,10712,5545961,59.64,1271,5179079,55.69,0,0,0,0,0,0,58.54,0,41.46
2021-06-24T00:00:00.000Z,12006,5557967,59.77,1441,5180520,55.71,0,0,0,0,0,0,58.62,0,41.38
2021-06-25T00:00:00.000Z,7080,5565047,59.84,909,5181429,55.72,0,0,0,0,0,0,58.67,0,41.33
2021-06-26T00:00:00.000Z,2256,5567303,59.87,187,5181616,55.72,0,0,0,0,0,0,58.68,0,41.32
2021-06-27T00:00:00.000Z,13607,5580910,60.01,3426,5185042,55.76,0,0,0,0,0,0,58.78,0,41.22
2021-06-28T00:00:00.000Z,14491,5595401,60.17,3652,5188694,55.8,0,0,0,0,0,0,58.88,0,41.12
2021-06-29T00:00:00.000Z,16681,5612082,60.35,3713,5192407,55.84,0,0,0,0,0,0,58.99,0,41.01
2021-06-30T00:00:00.000Z,16455,5628537,60.53,3370,5195777,55.87,0,0,0,0,0,0,59.11,0,40.89
2021-07-01T00:00:00.000Z,16784,5645321,60.71,3346,5199123,55.91,68,68,0,0,0,0,59.23,0,40.77
2021-07-02T00:00:00.000Z,9807,5655128,60.81,1571,5200694,55.93,4,72,0,0,0,0,59.3,0,40.7
2021-07-03T00:00:00.000Z,2656,5657784,60.84,286,5200980,55.93,0,72,0,0,0,0,59.32,0,40.68
2021-07-04T00:00:00.000Z,17715,5675499,61.03,3145,5204125,55.96,0,72,0,0,0,0,59.46,0,40.54
2021-07-05T00:00:00.000Z,17828,5693327,61.22,3015,5207140,55.99,4,76,0,0,0,0,59.6,0,40.4
2021-07-06T00:00:00.000Z,17815,5711142,61.41,3390,5210530,56.03,10,86,0,0,0,0,59.74,0,40.26
2021-07-07T00:00:00.000Z,15503,5726645,61.58,2663,5213193,56.06,11,97,0,0,0,0,59.87,0,40.13
2021-07-08T00:00:00.000Z,16555,5743200,61.76,2831,5216024,56.09,15,112,0,0,0,0,60,0,40
2021-07-09T00:00:00.000Z,11107,5754307,61.88,1503,5217527,56.11,3,115,0,0,0,0,60.09,0,39.91
2021-07-10T00:00:00.000Z,4960,5759267,61.93,372,5217899,56.11,5,120,0,0,0,0,60.13,0,39.87
2021-07-11T00:00:00.000Z,1445,5760712,61.95,2837,5220736,56.14,5,125,0,0,0,0,60.16,0,39.84
2021-07-12T00:00:00.000Z,2397,5763109,61.97,3667,5224403,56.18,50,175,0,0,0,0,60.2,0,39.8
2021-07-13T00:00:00.000Z,2939,5766048,62.01,5431,5229834,56.24,124,299,0,0,0,0,60.25,0,39.75
2021-07-14T00:00:00.000Z,2713,5768761,62.03,7489,5237323,56.32,440,739,0.01,0,0,0,60.29,0,39.71
2021-07-15T00:00:00.000Z,2965,5771726,62.07,9261,5246584,56.42,373,1112,0.01,0,0,0,60.34,0,39.66
2021-07-16T00:00:00.000Z,1257,5772983,62.08,5863,5252447,56.48,65,1177,0.01,0,0,0,60.36,0,39.64
2021-07-17T00:00:00.000Z,347,5773330,62.08,1376,5253823,56.5,6,1183,0.01,0,0,0,60.37,0,39.63
2021-07-18T00:00:00.000Z,2046,5775376,62.11,9757,5263580,56.6,235,1418,0.02,0,0,0,60.4,0,39.6
2021-07-19T00:00:00.000Z,3180,5778556,62.14,11317,5274897,56.72,457,1875,0.02,0,0,0,60.44,0,39.56
2021-07-20T00:00:00.000Z,2651,5781207,62.17,11882,5286779,56.85,370,2245,0.02,0,0,0,60.42,0.07,39.51
2021-07-21T00:00:00.000Z,2356,5783563,62.19,11849,5298628,56.98,322,2567,0.03,0,0,0,60.26,0.28,39.46
2021-07-22T00:00:00.000Z,2853,5786416,62.22,13228,5311856,57.12,389,2956,0.03,0,0,0,59.93,0.67,39.4
2021-07-23T00:00:00.000Z,2011,5788427,62.25,8198,5320054,57.21,102,3058,0.03,0,0,0,59.35,1.29,39.36
2021-07-24T00:00:00.000Z,615,5789042,62.25,1462,5321516,57.23,6,3064,0.03,0,0,0,58.61,2.04,39.35
2021-07-25T00:00:00.000Z,4406,5793448,62.3,15472,5336988,57.39,223,3287,0.04,0,0,0,58.29,2.43,39.28
2021-07-26T00:00:00.000Z,5145,5798593,62.36,13498,5350486,57.54,322,3609,0.04,0,0,0,58.1,2.71,39.19
2021-07-27T00:00:00.000Z,5461,5804054,62.41,13530,5364016,57.68,412,4021,0.04,0,0,0,57.27,3.63,39.1
2021-07-28T00:00:00.000Z,3963,5808017,62.46,12310,5376326,57.81,469,4490,0.05,0,0,0,56.05,4.93,39.02
2021-07-29T00:00:00.000Z,4634,5812651,62.51,14148,5390474,57.97,526,5016,0.05,0,0,0,54.65,6.41,38.93
2021-07-30T00:00:00.000Z,2632,5815283,62.53,10824,5401298,58.08,4114,9130,0.1,0,0,0,53.18,7.92,38.9
2021-07-31T00:00:00.000Z,1389,5816672,62.55,3533,5404831,58.12,6154,15284,0.16,0,0,0,51.46,9.64,38.9
2021-08-01T00:00:00.000Z,3060,5819732,62.58,3345,5408176,58.16,31041,46325,0.5,0,0,0,50.94,10.15,38.92
2021-08-02T00:00:00.000Z,3106,5822838,62.62,3147,5411323,58.19,58500,104825,1.13,0,0,0,50.72,10.24,39.03
2021-08-03T00:00:00.000Z,3361,5826199,62.65,3292,5414615,58.23,78951,183776,1.98,0,0,0,49.7,11.07,39.23
2021-08-04T00:00:00.000Z,3510,5829709,62.69,3224,5417839,58.26,80744,264520,2.84,0,0,0,48.7,11.86,39.44
2021-08-05T00:00:00.000Z,4486,5834195,62.74,3545,5421384,58.3,88432,352952,3.8,0,0,0,47.92,12.4,39.68
2021-08-06T00:00:00.000Z,2398,5836593,62.76,1822,5423206,58.32,44738,397690,4.28,0,0,0,46.97,13.26,39.77
2021-08-07T00:00:00.000Z,1015,5837608,62.77,659,5423865,58.33,27348,425038,4.57,0,0,0,45.82,14.34,39.84
2021-08-08T00:00:00.000Z,4992,5842600,62.83,3051,5426916,58.36,80067,505105,5.43,0,0,0,45.73,14.27,40
2021-08-09T00:00:00.000Z,5326,5847926,62.89,3027,5429943,58.39,76476,581581,6.25,0,0,0,45.97,13.98,40.05
2021-08-10T00:00:00.000Z,5537,5853463,62.95,3163,5433106,58.42,75410,656991,7.07,0,0,0,46.18,13.81,40.01
2021-08-11T00:00:00.000Z,5674,5859137,63.01,2919,5436025,58.46,62619,719610,7.74,0,0,0,46.57,13.52,39.91
2021-08-12T00:00:00.000Z,7013,5866150,63.08,3267,5439292,58.49,59448,779058,8.38,0,0,0,47.05,13.21,39.74
2021-08-13T00:00:00.000Z,3794,5869944,63.12,2043,5441335,58.51,43853,822911,8.85,0,0,0,47.01,13.29,39.7
2021-08-14T00:00:00.000Z,2247,5872191,63.15,836,5442171,58.52,44465,867376,9.33,0,0,0,46.77,13.49,39.74
2021-08-15T00:00:00.000Z,7157,5879348,63.22,4517,5446688,58.57,97944,965320,10.38,0,0,0,47.43,12.85,39.72
2021-08-16T00:00:00.000Z,6973,5886321,63.3,4722,5451410,58.62,89489,1054809,11.34,0,0,0,48.08,12.25,39.68
2021-08-17T00:00:00.000Z,7574,5893895,63.38,5115,5456525,58.68,83280,1138089,12.24,0,0,0,48.24,12.15,39.61
2021-08-18T00:00:00.000Z,8629,5902524,63.47,4588,5461113,58.73,69232,1207321,12.98,0,0,0,48.3,12.17,39.53
2021-08-19T00:00:00.000Z,10064,5912588,63.58,5193,5466306,58.78,65949,1273270,13.69,0,0,0,48.32,12.24,39.44
2021-08-20T00:00:00.000Z,4731,5917319,63.63,2789,5469095,58.81,60423,1333693,14.34,0,0,0,48.14,12.41,39.44
2021-08-21T00:00:00.000Z,3487,5920806,63.67,1551,5470646,58.83,50707,1384400,14.89,0,0,0,47.9,12.68,39.42
2021-08-22T00:00:00.000Z,9834,5930640,63.78,4783,5475429,58.88,105066,1489466,16.02,0,0,0,48.58,12.09,39.32
2021-08-23T00:00:00.000Z,10926,5941566,63.89,4422,5479851,58.93,93969,1583435,17.03,0,0,0,49.21,11.58,39.21
2021-08-24T00:00:00.000Z,11730,5953296,64.02,4687,5484538,58.98,98476,1681911,18.09,0,0,0,49.46,11.42,39.12
2021-08-25T00:00:00.000Z,9626,5962922,64.12,4456,5488994,59.03,99450,1781361,19.16,0,0,0,49.56,11.37,39.07
2021-08-26T00:00:00.000Z,10106,5973028,64.23,5028,5494022,59.08,101146,1882507,20.24,0,0,0,49.63,11.33,39.04
2021-08-27T00:00:00.000Z,4315,5977343,64.28,2756,5496778,59.11,56659,1939166,20.85,0,0,0,49.51,11.55,38.95
2021-08-28T00:00:00.000Z,3692,5981035,64.32,1475,5498253,59.13,33512,1972678,21.21,0,0,0,49.19,11.98,38.84
2021-08-29T00:00:00.000Z,10340,5991375,64.43,5925,5504178,59.19,79469,2052147,22.07,0,0,0,49.75,11.65,38.61
2021-08-30T00:00:00.000Z,12346,6003721,64.56,6995,5511173,59.26,115934,2168081,23.31,0,0,0,50.44,11.05,38.51
2021-08-31T00:00:00.000Z,12089,6015810,64.69,6495,5517668,59.33,114796,2282877,24.55,0,0,0,50.77,10.82,38.41
2021-09-01T00:00:00.000Z,9059,6024869,64.79,5990,5523658,59.4,112415,2395292,25.76,0,0,0,51.06,10.58,38.36
2021-09-02T00:00:00.000Z,8800,6033669,64.88,7151,5530809,59.48,111451,2506743,26.96,0,0,0,51.47,10.22,38.31
2021-09-03T00:00:00.000Z,3739,6037408,64.92,4087,5534896,59.52,58849,2565592,27.59,0,0,0,51.53,10.2,38.27
2021-09-04T00:00:00.000Z,2691,6040099,64.95,2004,5536900,59.54,29930,2595522,27.91,0,0,0,51.36,10.4,38.23
2021-09-05T00:00:00.000Z,7011,6047110,65.03,6447,5543347,59.61,73277,2668799,28.7,1,1,0,51.84,10.03,38.14
2021-09-06T00:00:00.000Z,2823,6049933,65.06,2674,5546021,59.64,22775,2691574,28.94,0,1,0,52.27,9.9,37.83
2021-09-07T00:00:00.000Z,1186,6051119,65.07,854,5546875,59.65,5381,2696955,29,0,1,0,52.37,10.13,37.5
2021-09-08T00:00:00.000Z,1373,6052492,65.09,1167,5548042,59.66,6608,2703563,29.07,0,1,0,52.44,10.39,37.17
2021-09-09T00:00:00.000Z,7103,6059595,65.16,12539,5560581,59.8,73792,2777355,29.87,0,1,0,52.79,10.21,36.99
2021-09-10T00:00:00.000Z,3245,6062840,65.2,4983,5565564,59.85,37908,2815263,30.27,0,1,0,52.75,10.34,36.91
2021-09-11T00:00:00.000Z,2108,6064948,65.22,2487,5568051,59.88,14800,2830063,30.43,0,1,0,52.38,10.77,36.85
2021-09-12T00:00:00.000Z,6117,6071065,65.29,8579,5576630,59.97,54091,2884154,31.01,0,1,0,52.69,10.57,36.74
2021-09-13T00:00:00.000Z,5624,6076689,65.35,8231,5584861,60.06,47922,2932076,31.53,0,1,0,52.86,10.37,36.76
2021-09-14T00:00:00.000Z,4954,6081643,65.4,7398,5592259,60.14,48818,2980894,32.06,0,1,0,52.63,10.52,36.85
2021-09-15T00:00:00.000Z,1737,6083380,65.42,2690,5594949,60.17,16669,2997563,32.23,0,1,0,52.21,10.93,36.86
2021-09-16T00:00:00.000Z,333,6083713,65.42,534,5595483,60.17,1735,2999298,32.25,0,1,0,51.98,11.42,36.59
2021-09-17T00:00:00.000Z,3674,6087387,65.46,6997,5602480,60.25,42865,3042163,32.71,0,1,0,51.93,11.5,36.57
2021-09-18T00:00:00.000Z,2249,6089636,65.48,2930,5605410,60.28,12777,3054940,32.85,0,1,0,51.53,11.93,36.54
2021-09-19T00:00:00.000Z,5967,6095603,65.55,10700,5616110,60.39,44285,3099225,33.33,0,1,0,51.73,11.82,36.44
2021-09-20T00:00:00.000Z,3239,6098842,65.58,4617,5620727,60.44,16681,3115906,33.51,0,1,0,51.86,11.84,36.3
2021-09-21T00:00:00.000Z,1326,6100168,65.6,2035,5622762,60.46,3465,3119371,33.54,0,1,0,51.53,12.34,36.13
2021-09-22T00:00:00.000Z,4256,6104424,65.64,7227,5629989,60.54,25035,3144406,33.81,0,1,0,51.13,12.74,36.12
2021-09-23T00:00:00.000Z,4396,6108820,65.69,5884,5635873,60.61,27794,3172200,34.11,0,1,0,50.75,13.08,36.17
2021-09-24T00:00:00.000Z,3196,6112016,65.73,4167,5640040,60.65,27696,3199896,34.41,0,1,0,50.65,13.27,36.08
2021-09-25T00:00:00.000Z,2079,6114095,65.75,2243,5642283,60.67,10422,3210318,34.52,0,1,0,50.32,13.63,36.05
2021-09-26T00:00:00.000Z,5622,6119717,65.81,5963,5648246,60.74,36229,3246547,34.91,0,1,0,50.56,13.48,35.95
2021-09-27T00:00:00.000Z,4695,6124412,65.86,4444,5652690,60.79,30422,3276969,35.24,1,2,0,50.72,13.33,35.95
2021-09-28T00:00:00.000Z,1459,6125871,65.87,1162,5653852,60.8,6228,3283197,35.31,0,2,0,50.48,13.59,35.94
2021-09-29T00:00:00.000Z,9643,6135514,65.98,8326,5662178,60.89,60268,3343465,35.95,0,2,0,50.67,13.36,35.97
2021-09-30T00:00:00.000Z,10975,6146489,66.1,8546,5670724,60.98,79649,3423114,36.81,0,2,0,51.24,12.7,36.07
2021-10-01T00:00:00.000Z,5117,6151606,66.15,3847,5674571,61.02,46489,3469603,37.31,0,2,0,51.32,12.6,36.08
2021-10-02T00:00:00.000Z,2863,6154469,66.18,2114,5676685,61.04,22411,3492014,37.55,0,2,0,51.24,12.67,36.09
2021-10-03T00:00:00.000Z,11676,6166145,66.31,7255,5683940,61.12,70682,3562696,38.31,0,2,0,51.81,12.09,36.11
2021-10-04T00:00:00.000Z,10323,6176468,66.42,6736,5690676,61.19,51852,3614548,38.87,0,2,0,52.28,11.63,36.09
2021-10-05T00:00:00.000Z,8451,6184919,66.51,5284,5695960,61.25,40435,3654983,39.3,0,2,0,52.55,11.31,36.15
2021-10-06T00:00:00.000Z,7573,6192492,66.59,4158,5700118,61.3,34065,3689048,39.67,0,2,0,52.9,11.14,35.96
2021-10-07T00:00:00.000Z,6911,6199403,66.67,3984,5704102,61.34,33998,3723046,40.04,0,2,0,53.39,10.91,35.7
2021-10-08T00:00:00.000Z,3086,6202489,66.7,2617,5706719,61.37,19205,3742251,40.24,0,2,0,53.62,10.82,35.56
2021-10-09T00:00:00.000Z,1332,6203821,66.71,1427,5708146,61.38,7422,3749673,40.32,0,2,0,53.66,10.85,35.49
2021-10-10T00:00:00.000Z,4684,6208505,66.76,3733,5711879,61.42,21488,3771161,40.55,0,2,0,54.13,10.63,35.24
2021-10-11T00:00:00.000Z,4296,6212801,66.81,2926,5714805,61.45,17235,3788396,40.74,0,2,0,54.51,10.44,35.05
2021-10-12T00:00:00.000Z,3971,6216772,66.85,2980,5717785,61.49,15333,3803729,40.9,0,2,0,54.66,10.42,34.91
2021-10-13T00:00:00.000Z,3494,6220266,66.89,2434,5720219,61.51,13531,3817260,41.05,0,2,0,54.81,10.41,34.78
2021-10-14T00:00:00.000Z,3870,6224136,66.93,2668,5722887,61.54,16519,3833779,41.23,0,2,0,55,10.34,34.66
2021-10-15T00:00:00.000Z,1695,6225831,66.95,1657,5724544,61.56,8979,3842758,41.32,0,2,0,55.07,10.34,34.59
2021-10-16T00:00:00.000Z,731,6226562,66.96,935,5725479,61.57,4017,3846775,41.37,0,2,0,55.02,10.42,34.56
2021-10-17T00:00:00.000Z,3106,6229668,66.99,2512,5727991,61.6,12762,3859537,41.5,0,2,0,55.21,10.31,34.48
2021-10-18T00:00:00.000Z,2455,6232123,67.02,1657,5729648,61.61,10029,3869566,41.61,0,2,0,55.36,10.23,34.41
2021-10-19T00:00:00.000Z,2385,6234508,67.04,1262,5730910,61.63,9271,3878837,41.71,0,2,0,55.42,10.23,34.35
2021-10-20T00:00:00.000Z,2437,6236945,67.07,2279,5733189,61.65,10052,3888889,41.82,0,2,0,55.49,10.21,34.3
2021-10-21T00:00:00.000Z,3029,6239974,67.1,3073,5736262,61.68,12108,3900997,41.95,0,2,0,55.64,10.12,34.24
2021-10-22T00:00:00.000Z,1273,6241247,67.12,1408,5737670,61.7,5798,3906795,42.01,0,2,0,55.7,10.09,34.21
2021-10-23T00:00:00.000Z,558,6241805,67.12,1249,5738919,61.71,2551,3909346,42.04,0,2,0,55.74,10.07,34.2
2021-10-24T00:00:00.000Z,2510,6244315,67.15,2652,5741571,61.74,9831,3919177,42.14,0,2,0,55.84,10.01,34.15
2021-10-25T00:00:00.000Z,2629,6246944,67.18,2716,5744287,61.77,8469,3927646,42.24,0,2,0,55.95,9.94,34.11
2021-10-26T00:00:00.000Z,2371,6249315,67.2,2030,5746317,61.79,8491,3936137,42.33,0,2,0,56.02,9.9,34.08
2021-10-27T00:00:00.000Z,2300,6251615,67.23,2545,5748862,61.82,7915,3944052,42.41,0,2,0,56.09,9.87,34.04
2021-10-28T00:00:00.000Z,2494,6254109,67.25,2747,5751609,61.85,8631,3952683,42.51,0,2,0,56.17,9.83,33.99
2021-10-29T00:00:00.000Z,885,6254994,67.26,1122,5752731,61.86,4101,3956784,42.55,0,2,0,56.19,9.84,33.98
2021-10-30T00:00:00.000Z,352,6255346,67.27,515,5753246,61.87,1698,3958482,42.57,0,2,0,56.16,9.87,33.96
2021-10-31T00:00:00.000Z,2268,6257614,67.29,2479,5755725,61.89,8224,3966706,42.66,0,2,0,56.26,9.81,33.93
2021-11-01T00:00:00.000Z,1730,6259344,67.31,2079,5757804,61.92,6438,3973144,42.73,0,2,0,56.35,9.76,33.89
2021-11-02T00:00:00.000Z,2025,6261369,67.33,2019,5759823,61.94,6247,3979391,42.79,1,3,0,56.4,9.74,33.86
2021-11-03T00:00:00.000Z,1761,6263130,67.35,1873,5761696,61.96,5511,3984902,42.85,0,3,0,56.43,9.74,33.83
2021-11-04T00:00:00.000Z,2108,6265238,67.37,2782,5764478,61.99,7082,3991984,42.93,0,3,0,56.49,9.72,33.79
2021-11-05T00:00:00.000Z,771,6266009,67.38,881,5765359,62,3430,3995414,42.96,0,3,0,56.48,9.73,33.78
2021-11-06T00:00:00.000Z,340,6266349,67.39,379,5765738,62,1359,3996773,42.98,0,3,0,56.45,9.77,33.77
2021-11-07T00:00:00.000Z,1585,6267934,67.4,1764,5767502,62.02,6112,4002885,43.05,0,3,0,56.53,9.73,33.74
2021-11-08T00:00:00.000Z,1513,6269447,67.42,1575,5769077,62.04,5373,4008258,43.1,0,3,0,56.6,9.68,33.72
2021-11-09T00:00:00.000Z,1425,6270872,67.43,1581,5770658,62.05,5296,4013554,43.16,0,3,0,56.63,9.67,33.7
2021-11-10T00:00:00.000Z,1428,6272300,67.45,1638,5772296,62.07,4730,4018284,43.21,0,3,0,56.66,9.67,33.68
2021-11-11T00:00:00.000Z,1627,6273927,67.47,1920,5774216,62.09,5655,4023939,43.27,3,6,0,56.71,9.64,33.65
2021-11-12T00:00:00.000Z,620,6274547,67.47,804,5775020,62.1,2884,4026823,43.3,0,6,0,56.72,9.64,33.64
2021-11-13T00:00:00.000Z,248,6274795,67.48,279,5775299,62.1,1104,4027927,43.31,0,6,0,56.71,9.66,33.63
2021-11-14T00:00:00.000Z,1544,6276339,67.49,1622,5776921,62.12,5085,4033012,43.37,1,7,0,56.77,9.62,33.61
2021-11-15T00:00:00.000Z,1263,6277602,67.51,1604,5778525,62.14,4740,4037752,43.42,0,7,0,56.83,9.58,33.59
2021-11-16T00:00:00.000Z,1278,6278880,67.52,1390,5779915,62.15,4296,4042048,43.47,0,7,0,56.86,9.57,33.57
2021-11-17T00:00:00.000Z,1212,6280092,67.53,1541,5781456,62.17,3848,4045896,43.51,0,7,0,56.89,9.57,33.55
2021-11-18T00:00:00.000Z,1354,6281446,67.55,1666,5783122,62.19,4968,4050864,43.56,0,7,0,56.93,9.54,33.53
2021-11-19T00:00:00.000Z,585,6282031,67.55,741,5783863,62.2,2413,4053277,43.59,0,7,0,56.94,9.54,33.52
2021-11-20T00:00:00.000Z,233,6282264,67.56,234,5784097,62.2,903,4054180,43.6,1,8,0,56.93,9.56,33.51
2021-11-21T00:00:00.000Z,1426,6283690,67.57,1517,5785614,62.22,4847,4059027,43.65,0,8,0,56.98,9.52,33.5
2021-11-22T00:00:00.000Z,1675,6285365,67.59,1504,5787118,62.23,4190,4063217,43.69,1,9,0,57.04,9.48,33.47
2021-11-23T00:00:00.000Z,8616,6293981,67.68,1662,5788780,62.25,3952,4067169,43.74,0,9,0,57.14,9.46,33.4
2021-11-24T00:00:00.000Z,9355,6303336,67.78,1293,5790073,62.26,3869,4071038,43.78,0,9,0,57.23,9.44,33.33
2021-11-25T00:00:00.000Z,9821,6313157,67.89,1576,5791649,62.28,4794,4075832,43.83,0,9,0,57.31,9.44,33.25
2021-11-26T00:00:00.000Z,5608,6318765,67.95,727,5792376,62.29,2735,4078567,43.86,0,9,0,57.34,9.46,33.21
2021-11-27T00:00:00.000Z,4777,6323542,68,312,5792688,62.29,1134,4079701,43.87,0,9,0,57.35,9.48,33.17
2021-11-28T00:00:00.000Z,10154,6333696,68.11,1474,5794162,62.31,4867,4084568,43.92,0,9,0,57.46,9.45,33.09
2021-11-29T00:00:00.000Z,9038,6342734,68.21,1123,5795285,62.32,4322,4088890,43.97,0,9,0,57.57,9.42,33.01
2021-11-30T00:00:00.000Z,10046,6352780,68.31,1004,5796289,62.33,4032,4092922,44.01,1,10,0,57.65,9.42,32.93
2021-12-01T00:00:00.000Z,8625,6361405,68.41,1080,5797369,62.34,4379,4097301,44.06,2,12,0,57.73,9.42,32.86
2021-12-02T00:00:00.000Z,9171,6370576,68.51,1429,5798798,62.36,5048,4102349,44.11,4,16,0,57.82,9.4,32.78
2021-12-03T00:00:00.000Z,6339,6376915,68.57,651,5799449,62.36,2810,4105159,44.14,1,17,0,57.87,9.4,32.73
2021-12-04T00:00:00.000Z,2505,6379420,68.6,228,5799677,62.37,890,4106049,44.15,1,18,0,57.88,9.41,32.71
2021-12-05T00:00:00.000Z,8336,6387756,68.69,1248,5800925,62.38,4653,4110702,44.2,0,18,0,57.98,9.39,32.63
2021-12-06T00:00:00.000Z,6726,6394482,68.76,1184,5802109,62.39,4297,4114999,44.25,2,20,0,58.07,9.36,32.57
2021-12-07T00:00:00.000Z,5553,6400035,68.82,1489,5803598,62.41,3912,4118911,44.29,3,23,0,58.13,9.35,32.52
2021-12-08T00:00:00.000Z,4931,6404966,68.88,1185,5804783,62.42,3819,4122730,44.33,3,26,0,58.19,9.33,32.48
2021-12-09T00:00:00.000Z,6243,6411209,68.94,1220,5806003,62.43,4455,4127185,44.38,5,31,0,58.27,9.31,32.42
2021-12-10T00:00:00.000Z,3008,6414217,68.98,672,5806675,62.44,2622,4129807,44.41,1,32,0,58.31,9.3,32.39
2021-12-11T00:00:00.000Z,1490,6415707,68.99,248,5806923,62.44,981,4130788,44.42,0,32,0,58.32,9.3,32.38
2021-12-12T00:00:00.000Z,7278,6422985,69.07,1430,5808353,62.46,5213,4136001,44.48,1,33,0,58.42,9.27,32.32
2021-12-13T00:00:00.000Z,6181,6429166,69.14,1354,5809707,62.47,4299,4140300,44.52,1,34,0,58.5,9.24,32.26
2021-12-14T00:00:00.000Z,7326,6436492,69.21,6083,5815790,62.54,4878,4145178,44.58,7,41,0,58.59,9.21,32.2
2021-12-15T00:00:00.000Z,7206,6443698,69.29,7396,5823186,62.62,5390,4150568,44.63,1,42,0,58.68,9.18,32.14
2021-12-16T00:00:00.000Z,8080,6451778,69.38,8602,5831788,62.71,6493,4157061,44.7,5,47,0,58.78,9.15,32.07
2021-12-17T00:00:00.000Z,4390,6456168,69.43,5118,5836906,62.77,3886,4160947,44.74,3,50,0,58.83,9.14,32.04
2021-12-18T00:00:00.000Z,3936,6460104,69.47,2900,5839806,62.8,1319,4162266,44.76,1,51,0,58.86,9.14,32.01
2021-12-19T00:00:00.000Z,6986,6467090,69.54,9326,5849132,62.9,6231,4168497,44.83,2,53,0,58.96,9.1,31.94
2021-12-20T00:00:00.000Z,7982,6475072,69.63,7506,5856638,62.98,5361,4173858,44.88,4,57,0,59.05,9.08,31.87
2021-12-21T00:00:00.000Z,9556,6484628,69.73,8633,5865271,63.07,6409,4180267,44.95,2,59,0,59.18,9.05,31.77
2021-12-22T00:00:00.000Z,9669,6494297,69.84,8132,5873403,63.16,6185,4186452,45.02,7,66,0,59.31,9.03,31.66
2021-12-23T00:00:00.000Z,11549,6505846,69.96,10257,5883660,63.27,8077,4194529,45.11,9,75,0,59.46,9,31.54
2021-12-24T00:00:00.000Z,5887,6511733,70.02,6234,5889894,63.34,5212,4199741,45.16,3,78,0,59.55,8.98,31.47
2021-12-25T00:00:00.000Z,3337,6515070,70.06,2564,5892458,63.36,2015,4201756,45.18,3,81,0,59.59,8.98,31.44
2021-12-26T00:00:00.000Z,10659,6525729,70.17,8911,5901369,63.46,8177,4209933,45.27,5,86,0,59.75,8.93,31.32
2021-12-27T00:00:00.000Z,10374,6536103,70.29,7136,5908505,63.54,8134,4218067,45.36,79,165,0,59.9,8.89,31.21
2021-12-28T00:00:00.000Z,11380,6547483,70.41,7435,5915940,63.62,9581,4227648,45.46,89,254,0,60.05,8.86,31.09
2021-12-29T00:00:00.000Z,9957,6557440,70.52,5957,5921897,63.68,8302,4235950,45.55,9,263,0,60.19,8.83,30.98
2021-12-30T00:00:00.000Z,11021,6568461,70.63,7725,5929622,63.76,12195,4248145,45.68,4,267,0,60.36,8.79,30.86
2021-12-31T00:00:00.000Z,4838,6573299,70.69,3668,5933290,63.8,7255,4255400,45.76,81,348,0,60.44,8.77,30.8
2022-01-01T00:00:00.000Z,1991,6575290,70.71,1588,5934878,63.82,2737,4258137,45.79,34,382,0,60.46,8.76,30.77
2022-01-02T00:00:00.000Z,10226,6585516,70.82,6488,5941366,63.89,12971,4271108,45.93,331,713,0.01,60.63,8.71,30.66
2022-01-03T00:00:00.000Z,9391,6594907,70.92,5243,5946609,63.95,11280,4282388,46.05,11982,12695,0.14,60.78,8.66,30.56
2022-01-04T00:00:00.000Z,8971,6603878,71.01,5940,5952549,64.01,10470,4292858,46.16,50328,63023,0.68,60.91,8.64,30.46
2022-01-05T00:00:00.000Z,8557,6612435,71.11,5726,5958275,64.07,10424,4303282,46.28,59580,122603,1.32,61.03,8.61,30.37
2022-01-06T00:00:00.000Z,10347,6622782,71.22,7957,5966232,64.16,13485,4316767,46.42,63980,186583,2.01,61.18,8.56,30.26
2022-01-07T00:00:00.000Z,4756,6627538,71.27,4542,5970774,64.21,8098,4324865,46.51,31132,217715,2.34,61.25,8.54,30.21
2022-01-08T00:00:00.000Z,2751,6630289,71.3,2444,5973218,64.23,5466,4330331,46.57,27622,245337,2.64,61.28,8.53,30.19
2022-01-09T00:00:00.000Z,9315,6639604,71.4,7728,5980946,64.32,11841,4342172,46.69,66816,312153,3.36,61.43,8.48,30.09
2022-01-10T00:00:00.000Z,8369,6647973,71.49,7647,5988593,64.4,11821,4353993,46.82,64838,376991,4.05,61.57,8.43,30
2022-01-11T00:00:00.000Z,8108,6656081,71.58,8616,5997209,64.49,11924,4365917,46.95,56679,433670,4.66,61.69,8.4,29.91
2022-01-12T00:00:00.000Z,7276,6663357,71.65,8312,6005521,64.58,11064,4376981,47.07,44595,478265,5.14,61.81,8.35,29.83
2022-01-13T00:00:00.000Z,7516,6670873,71.74,9613,6015134,64.68,11491,4388472,47.19,34756,513021,5.52,62,8.27,29.73
2022-01-14T00:00:00.000Z,2556,6673429,71.76,4923,6020057,64.74,6100,4394572,47.26,11161,524182,5.64,62.08,8.23,29.69
2022-01-15T00:00:00.000Z,1463,6674892,71.78,3161,6023218,64.77,3850,4398422,47.3,5713,529895,5.7,62.12,8.21,29.66
2022-01-16T00:00:00.000Z,3821,6678713,71.82,8518,6031736,64.86,7653,4406075,47.38,19996,549891,5.91,62.26,8.14,29.6
2022-01-17T00:00:00.000Z,2811,6681524,71.85,7041,6038777,64.94,6134,4412209,47.45,17831,567722,6.11,62.4,8.06,29.54
2022-01-18T00:00:00.000Z,2476,6684000,71.88,7368,6046145,65.02,5479,4417688,47.51,14843,582565,6.26,62.53,8,29.47
2022-01-19T00:00:00.000Z,1885,6685885,71.9,6358,6052503,65.09,4474,4422162,47.55,8444,591009,6.36,62.7,7.89,29.41
2022-01-20T00:00:00.000Z,1781,6687666,71.92,6956,6059459,65.16,4759,4426921,47.6,8034,599043,6.44,62.8,7.85,29.35
2022-01-21T00:00:00.000Z,900,6688566,71.93,3722,6063181,65.2,2601,4429522,47.63,3350,602393,6.48,62.92,7.77,29.32
2022-01-22T00:00:00.000Z,329,6688895,71.93,1456,6064637,65.22,1042,4430564,47.64,1110,603503,6.49,63,7.71,29.29
2022-01-23T00:00:00.000Z,1064,6689959,71.94,5623,6070260,65.28,2859,4433423,47.67,6082,609585,6.56,63.13,7.63,29.24
2022-01-24T00:00:00.000Z,755,6690714,71.95,4480,6074740,65.32,2236,4435659,47.7,5055,614640,6.61,63.22,7.58,29.2
2022-01-25T00:00:00.000Z,741,6691455,71.96,4395,6079135,65.37,2153,4437812,47.72,7090,621730,6.69,63.28,7.56,29.17
2022-01-26T00:00:00.000Z,614,6692069,71.96,3279,6082414,65.41,1584,4439396,47.74,4257,625987,6.73,63.37,7.5,29.13
2022-01-27T00:00:00.000Z,792,6692861,71.97,4401,6086815,65.45,1969,4441365,47.76,5432,631419,6.79,63.45,7.46,29.09
2022-01-28T00:00:00.000Z,394,6693255,71.98,2370,6089185,65.48,1137,4442502,47.77,3439,634858,6.83,63.49,7.44,29.06
2022-01-29T00:00:00.000Z,124,6693379,71.98,1037,6090222,65.49,403,4442905,47.78,1160,636018,6.84,63.57,7.39,29.05
2022-01-30T00:00:00.000Z,772,6694151,71.99,4713,6094935,65.54,2001,4444906,47.8,8093,644111,6.93,63.66,7.32,29.01
2022-01-31T00:00:00.000Z,528,6694679,71.99,3181,6098116,65.58,1585,4446491,47.82,6461,650572,7,63.84,7.19,28.98
2022-02-01T00:00:00.000Z,475,6695154,72,2776,6100892,65.61,1492,4447983,47.83,5709,656281,7.06,63.87,7.18,28.95
2022-02-02T00:00:00.000Z,374,6695528,72,2382,6103274,65.63,1351,4449334,47.85,5052,661333,7.11,63.88,7.19,28.93
2022-02-03T00:00:00.000Z,443,6695971,72.01,2774,6106048,65.66,1426,4450760,47.86,5596,666929,7.17,63.91,7.18,28.91
2022-02-04T00:00:00.000Z,175,6696146,72.01,985,6107033,65.67,726,4451486,47.87,2444,669373,7.2,63.94,7.17,28.89
2022-02-05T00:00:00.000Z,59,6696205,72.01,337,6107370,65.68,203,4451689,47.87,418,669791,7.2,63.91,7.2,28.89
2022-02-06T00:00:00.000Z,407,6696612,72.01,2316,6109686,65.7,1329,4453018,47.89,5672,675463,7.26,63.98,7.16,28.86
2022-02-07T00:00:00.000Z,279,6696891,72.02,1305,6110991,65.71,952,4453970,47.9,5945,681408,7.33,64.04,7.12,28.84
2022-02-08T00:00:00.000Z,311,6697202,72.02,1495,6112486,65.73,1037,4455007,47.91,6125,687533,7.39,64.09,7.09,28.83
2022-02-09T00:00:00.000Z,243,6697445,72.02,1091,6113577,65.74,917,4455924,47.92,4570,692103,7.44,64.12,7.07,28.81
2022-02-10T00:00:00.000Z,268,6697713,72.02,1289,6114866,65.76,916,4456840,47.93,4810,696913,7.49,64.15,7.05,28.8
2022-02-11T00:00:00.000Z,181,6697894,72.03,535,6115401,65.76,501,4457341,47.93,2525,699438,7.52,64.19,7.02,28.79
2022-02-12T00:00:00.000Z,26,6697920,72.03,89,6115490,65.76,109,4457450,47.93,262,699700,7.52,64.2,7.02,28.79
2022-02-13T00:00:00.000Z,286,6698206,72.03,947,6116437,65.77,957,4458407,47.94,4991,704691,7.58,64.24,6.98,28.78
2022-02-14T00:00:00.000Z,179,6698385,72.03,621,6117058,65.78,734,4459141,47.95,3128,707819,7.61,64.31,6.92,28.77
2022-02-15T00:00:00.000Z,265,6698650,72.03,762,6117820,65.79,908,4460049,47.96,3806,711625,7.65,64.34,6.91,28.76
2022-02-16T00:00:00.000Z,180,6698830,72.04,575,6118395,65.79,780,4460829,47.97,2477,714102,7.68,64.35,6.9,28.75
2022-02-17T00:00:00.000Z,247,6699077,72.04,735,6119130,65.8,753,4461582,47.98,3047,717149,7.71,64.37,6.89,28.74
2022-02-18T00:00:00.000Z,128,6699205,72.04,318,6119448,65.81,422,4462004,47.98,1114,718263,7.72,64.39,6.87,28.74
2022-02-19T00:00:00.000Z,17,6699222,72.04,80,6119528,65.81,70,4462074,47.98,74,718337,7.72,64.39,6.87,28.74
2022-02-20T00:00:00.000Z,204,6699426,72.04,604,6120132,65.81,711,4462785,47.99,2564,720901,7.75,64.42,6.85,28.73
2022-02-21T00:00:00.000Z,168,6699594,72.04,406,6120538,65.82,466,4463251,48,1534,722435,7.77,64.44,6.83,28.72
2022-02-22T00:00:00.000Z,155,6699749,72.05,451,6120989,65.82,553,4463804,48,1860,724295,7.79,64.45,6.83,28.72
2022-02-23T00:00:00.000Z,109,6699858,72.05,350,6121339,65.83,443,4464247,48.01,1148,725443,7.8,64.45,6.84,28.71
2022-02-24T00:00:00.000Z,137,6699995,72.05,452,6121791,65.83,552,4464799,48.01,1485,726928,7.82,64.44,6.85,28.71
2022-02-25T00:00:00.000Z,55,6700050,72.05,137,6121928,65.83,181,4464980,48.01,451,727379,7.82,64.44,6.85,28.71
2022-02-26T00:00:00.000Z,15,6700065,72.05,26,6121954,65.83,147,4465127,48.02,34,727413,7.82,64.43,6.86,28.71
2022-02-27T00:00:00.000Z,109,6700174,72.05,338,6122292,65.84,444,4465571,48.02,1119,728532,7.83,64.44,6.86,28.7
2022-02-28T00:00:00.000Z,109,6700283,72.05,262,6122554,65.84,406,4465977,48.02,901,729433,7.84,64.45,6.85,28.7
2022-03-01T00:00:00.000Z,92,6700375,72.05,277,6122831,65.84,357,4466334,48.03,788,730221,7.85,64.44,6.86,28.7
2022-03-02T00:00:00.000Z,75,6700450,72.05,199,6123030,65.84,315,4466649,48.03,690,730911,7.86,64.43,6.87,28.69
2022-03-03T00:00:00.000Z,150,6700600,72.05,366,6123396,65.85,480,4467129,48.04,985,731896,7.87,64.43,6.88,28.69
2022-03-04T00:00:00.000Z,48,6700648,72.06,126,6123522,65.85,157,4467286,48.04,228,732124,7.87,64.42,6.89,28.69
2022-03-05T00:00:00.000Z,1,6700649,72.06,23,6123545,65.85,38,4467324,48.04,29,732153,7.87,64.41,6.9,28.69
2022-03-06T00:00:00.000Z,93,6700742,72.06,257,6123802,65.85,408,4467732,48.04,760,732913,7.88,64.41,6.91,28.69
2022-03-07T00:00:00.000Z,89,6700831,72.06,255,6124057,65.86,341,4468073,48.05,602,733515,7.89,64.41,6.9,28.68
2022-03-08T00:00:00.000Z,100,6700931,72.06,264,6124321,65.86,328,4468401,48.05,541,734056,7.89,64.4,6.92,28.68
2022-03-09T00:00:00.000Z,85,6701016,72.06,212,6124533,65.86,326,4468727,48.05,488,734544,7.9,64.38,6.94,28.68
2022-03-10T00:00:00.000Z,111,6701127,72.06,362,6124895,65.86,417,4469144,48.06,614,735158,7.91,64.36,6.96,28.68
2022-03-11T00:00:00.000Z,24,6701151,72.06,85,6124980,65.86,113,4469257,48.06,141,735299,7.91,64.35,6.98,28.68
2022-03-12T00:00:00.000Z,6,6701157,72.06,9,6124989,65.87,25,4469282,48.06,22,735321,7.91,64.33,7,28.67
2022-03-13T00:00:00.000Z,92,6701249,72.06,272,6125261,65.87,354,4469636,48.06,589,735910,7.91,64.32,7.01,28.67
2022-03-14T00:00:00.000Z,62,6701311,72.06,249,6125510,65.87,308,4469944,48.07,556,736466,7.92,64.32,7.01,28.67
2022-03-15T00:00:00.000Z,81,6701392,72.06,180,6125690,65.87,279,4470223,48.07,579,737045,7.93,64.3,7.03,28.67
2022-03-16T00:00:00.000Z,73,6701465,72.06,204,6125894,65.87,298,4470521,48.07,665,737710,7.93,64.29,7.04,28.67
2022-03-17T00:00:00.000Z,63,6701528,72.06,120,6126014,65.88,279,4470800,48.08,601,738311,7.94,64.29,7.04,28.67
2022-03-18T00:00:00.000Z,18,6701546,72.07,52,6126066,65.88,96,4470896,48.08,225,738536,7.94,64.29,7.04,28.67
2022-03-19T00:00:00.000Z,5,6701551,72.07,10,6126076,65.88,23,4470919,48.08,35,738571,7.94,64.24,7.1,28.67
2022-03-20T00:00:00.000Z,116,6701667,72.07,254,6126330,65.88,477,4471396,48.08,1426,739997,7.96,64.22,7.11,28.66
2022-03-21T00:00:00.000Z,97,6701764,72.07,241,6126571,65.88,367,4471763,48.09,1119,741116,7.97,64.22,7.12,28.66
2022-03-22T00:00:00.000Z,142,6701906,72.07,340,6126911,65.89,490,4472253,48.09,1763,742879,7.99,64.19,7.15,28.66
2022-03-23T00:00:00.000Z,108,6702014,72.07,207,6127118,65.89,446,4472699,48.1,1666,744545,8.01,64.15,7.19,28.66
2022-03-24T00:00:00.000Z,176,6702190,72.07,334,6127452,65.89,743,4473442,48.11,2348,746893,8.03,64.13,7.21,28.66
2022-03-25T00:00:00.000Z,35,6702225,72.07,75,6127527,65.89,149,4473591,48.11,618,747511,8.04,64.13,7.21,28.66
2022-03-26T00:00:00.000Z,11,6702236,72.07,11,6127538,65.89,31,4473622,48.11,88,747599,8.04,64.13,7.22,28.66
2022-03-27T00:00:00.000Z,157,6702393,72.07,331,6127869,65.9,755,4474377,48.12,3180,750779,8.07,64.11,7.24,28.66
2022-03-28T00:00:00.000Z,42,6702435,72.07,95,6127964,65.9,224,4474601,48.12,1043,751822,8.08,64.1,7.24,28.65
